adnow: adown downa wando
ehstw: thews whets
cdeeiln: cleedin decline
abdest: basted debats
mnor: morn norm
efist: feist fites setif
deensst: densest sendest
ckrstu: struck trucks
adeemnor: demeanor enamored
ees: ees see
achimnops: champions compashin
cdeeiinrst: indirectes indiscreet iridescent
glu: gul lug
aelrst: alters salter slater staler
acnors: acorns carson
aflos: falso olafs
begins: begins beings
ostt: tost tots
deef: deef feed
aehrstt: hatters shatter threats
aelnpst: planets plantes plesant
adeelrt: altered related
beersstw: bestrews websters
gginrsu: surging urgings
abddeiorss: broadsides sideboards
deloop: looped poodle
abbbdel: babbled blabbed
aglos: gaols goals
emnosy: moneys moyens
ehirt: erith ither
giinnprst: printings sprinting
giiknrst: skirting striking
iot: ito toi
orst: rots sort
apsw: paws swap wasp
adeehr: adhere header heeard
aadmrs: dramas madras
aehrsu: ashure hauser
ceinprs: pincers princes
aahnnt: nahant nathan
aagnor: angora aragon
aknru: karun kunar kurna
ahl: hal lah
ccehor: cocher cochre
aeelmn: emlaen enamel
eist: esti etsi seit seti site ties
adiimnnoot: admonition domination
cehor: chore ocher ochre
beinrt: bentir breint
adipr: pardi rapid
emors: meros morse sermo
aceehrrs: research searcher
deorst: dorset rosted sorted stored strode
deirr: direr drier rider
aelss: sales seals slaes
adeenry: deanery yearned
en: en ne
eeginor: erigone regione
ddeor: droed odder
eglnou: longue lounge
aehimr: hermia himera
aisv: avis savi siva vais vias
adgilnu: languid lauding
acehss: cashes chasse
eioprsuv: pervious previous
elmst: melts smelt
aeinorstt: attornies stationer
af: af fa
abceinr: barcine carbine
blow: blow bowl
aehr: hare hear hera rhea
eflt: felt left
ac: ac ca
aceinnort: connaitre container
ehirtv: thrive vreith
aeegnrv: avenger engrave
nnooopst: pontoons spontoon
aeil: elai elia
cdekor: corked rocked
deru: rude rued
cdeeimn: endemic medecin
anost: aston santo
egorv: evrog grove
acehmrs: charmes marches
ceeginors: congeries recognise
eehoorsvw: howsoever whosoever
eknorsy: orkneys yonkers
cceinors: conciser cornices
optu: pout puto
cno: con noc
aimn: anim main mian mina
adnor: adorn ronda
adsw: daws wads
agns: angs nags sang snag
aeilmnst: ailments maestlin manliest stileman
dei: dei die
aeeimss: messiae siamese
ddeglo: goledd lodged
abdr: bard drab
chotuy: couthy touchy
cemot: comet comte
aelv: lave vale veal vela
acceisst: accessit ascetics
ggiilnns: singling slinging
ceghin: cheing eching
acest: caste secta
eegillnrv: grenville revelling
cru: cru cur
aenrssw: answers rawness
eemprsu: persume presume supreme
dy: dy yd
eeelv: eleve leeve levee
lotu: lout olut
aeehrsw: warhees whereas
aeflstuw: awfulest wasteful
intu: nuit unit
beilmrt: timbrel trimbel
addegw: agwedd gwaedd
eor: ero oer ore roe
aelrv: arvel laver ravel
ikns: inks sink skin
eeft: feet fete
deost: doest dotes
een: een ene nee
admnoy: dynamo dyomna monday
enrrtu: return turner
abdehins: banished bashedin
afikrs: fakirs kafirs
cot: cot oct
eiprst: esprit priest ripest sperit sprite stripe
adglly: gladly llygad
aadr: adar arad dara
accehnor: cochrane encroach
ikst: kist kits
co: co oc
eilln: enlil neill
acelmr: calmer carmel marcel
ailrs: lairs liars rails
egrt: gert regt
akos: oaks soak
ant: ant nat tan
diny: dyin indy
adenu: duane neuad
ghirst: girths rights
host: host shot
ehnos: hosen shone
aegilnrst: integrals triangles
aclorr: carrol corral
ceirrstt: critters restrict stricter
ddeilnsw: dwindles swindled
eefginr: freeing reefing
dfior: fiord froid
hinpsu: punish pushin
ehnry: henry heyrn hyrne
aeiprr: pareri perira rapier repair
agr: gar rag
deglo: lodge ogled
deerv: veder verde
acdeinoort: coordinate decoration
amy: amy yam
acdelrsy: sacredly scaredly
adeerr: dearer reader reared
eimnr: merin miner
aenpy: panye payne
elorsw: lowers slower
aeeilrstv: relatives versatile
aisstw: swatis waists
kooty: kyoto tokyo
aabbdeors: barbadoes baseboard
aegp: gape page
iknst: knits stink
amnor: manor norma roman
eir: eir ire rei
cdeou: coude douce
adepst: adepts pasted
arwy: awry awyr wary wyar
aknsy: snaky yanks
emmor: memor morem
aadgnn: dagnan dangan
als: als las
adeemnrs: esmenard meanders
adenr: andre arden
beosss: bosses obsess
aeimrs: armies maries
gru: gur rug
eeimprs: empires premise
ginotv: vignot voting
ceeinrsu: insecure sinecure
beehrsw: beshrew hebrews
aeinrrsst: restrains strainers
aehimpsst: shipmates steamship
adery: deary rayed ready
cnnoy: cnoyn cynon
eegin: genie negei neige
binos: bonis nobis
oprt: port trop
acerst: carest carets cartes caster reacts recast traces
aeprstt: pratest spatter
aeinns: insane sienna
aenoss: saeson season
hkoos: hooks koosh shook
adny: andy ynad
ny: ny yn
eghorstu: resought roughest
ginortu: routing touring
deiis: dieis seidi
bi: bi ib
abeelnr: ebranle enabler
efoss: fesso fosse
aistv: savit vaits vista vitas
deinnt: indent intend tinned
eirsw: weirs wires wiser
acos: caso cosa saco
cehnos: chosen schoen
ceiors: cosier recois
aeelsv: leaves saleve sleave
iisv: ivis visi
aamnu: manau mauna
eehlt: ethel lethe
aceprst: carpets spectra
accilno: conical laconic
aenprstt: patterns transept
eegimnt: meeting teeming
acery: carey rayce
ailrst: trails trials
ann: ann nan
abgrs: garbs grabs
ehilstw: whilest whistle
acdeimno: comedian demoniac
censt: cents scent
adimst: admits amidst
eilnuv: unveil vuelin
aginprs: parings rasping sparing
acrst: carts scart scrat
opu: pou upo
alms: alms slam smal
abehlortt: betrothal harbottle
der: der red
ehi: hei hie
cens: cens scen
allosw: allows sallow
aiilprs: aprilis plaisir
aclrw: clawr crawl
adns: ands dans sand
deeghin: heeding neighed nieghed
abelry: barely barley
aginss: assign assing
adem: dame emda made mead
bgilnow: blowing bowling
aenrrw: warner warren
aanw: anaw nawa
eiknpr: perkin pinker
aacln: calan canal
cehirv: veirch vreich
acdeert: catered created reacted
aloprt: patrol portal
adeegrw: edgware wagered
egilstu: tegulis ugliest
aeepprrs: paperers prepares
aehkrsw: hawkers kershaw
alsty: salty slaty
acehmnrt: marchent merchant
aceilor: calorie coralie
ehlo: hoel hole
egln: glen leng
eenrsv: envers nerves nevers severn
deilsy: yeilds yields
aaeilmnprst: parliaments paternalism
aekrst: streak takers
acistt: attics static
aegiloops: apologies apologise
aehnsv: havens shaven
ahiprs: parish rispah shairp
dilo: idol lido lodi
egilu: guile ligue
cdeeoprrsu: procedures reproduces
abdeg: badge begad
ipsu: pius puis
aefnnoorst: afternoons safternoon
aemrtu: mature mutare turmae
ei: ei ie
dhlopu: holdup uphold
aeflnr: falern flaner
aers: arse ears eras rase reas sear sera
ceiist: cities iciest
aceeiipprtt: peripatetic precipitate
eirsst: resist risest sister
acgilnps: clasping scalping
acdenru: durance uncared
aegint: eating genait
aelos: aloes alsoe
eginntt: netting tenting
alotuy: layout outlay
achy: achy chay
adeennrs: andersen ardennes ensnared
eens: ense seen sene
degoo: godoe gooed
cinot: conti tonic
deginnt: denting tending
florsu: florus flours
abenr: abner bearn
eflow: fowle wolfe
aeelnr: leaner learne
deenrsu: endures ensured
aegrrt: garret garter grater
aeinv: evian naive vaine
aelstv: valets vestal
aeilnpss: painless spaniels
elmno: lemon melon
iklls: kills skill
eilsv: evils lives veils
ejsstu: justes sujets
egn: eng gen
egilmnort: gilmerton tremoling
delu: duel dule lued
aellrsu: allures laurels
eiimnt: intime meitin
deiinrt: dirtien inditer
aacelsu: alcaeus saecula
aacdiilp: lapicida placidia
cceeeiinnnnov: inconveinence inconvenience
eelnvy: evelyn evenly
acinot: action antico
aknor: akron koran
adu: aud dau
destu: duets suted
esw: sew wes
einstt: settin sitten
defil: field filed
aeeilnpst: palestine penalties
aoprrty: portray proyart
eortv: overt trove vetro voter votre
aprw: warp wrap
eiprsst: esprits persist priests sperits sprites stirpes stripes
celosst: closest closets
ceinot: noetic notice
beirr: berri brier
arstt: start tarts
alop: apol opal
amsu: musa suam
adeiinrst: intersaid trainside
beegl: gebel glebe
adeinr: darien rained readin
anrt: rant tarn
eipqu: equip pique
einoprstu: eruptions petronius
aellru: allure laurel
degnoru: guerdon undergo
ahimst: mathis mistah
ghost: ghost goths
aims: aims amis mais siam
aginort: grotian orating
addinrtw: drindawt trindawd
chirtu: trihuc turchi
ikny: inky kyin
aeehrtt: theater theatre thereat
abinrs: bairns barins brains
beno: beno bone ebon
aeprrt: parret parter prater
eghiimntt: minghetti nighttime
eegl: egle glee lege
elrsu: leurs lures rules
deinnst: indents intends
adegw: gwaed waged
deer: deer dere eerd reed
bddeginru: dunbridge unbridged
acimnos: masonic sociman
abersstu: abstruse arbustes
adeikrs: darkies skaired
einort: ireton orient
deelnrs: lenders slender
aagmn: amang magna
eehps: ephes sheep
ahorz: zohra zorah
efir: fier fire rife
hinnot: hinton nothin
aeeflrw: farewel welfare
adeiimnosstu: eudaimonists moutainsides
adenttu: attuned taunted
almo: loam malo
aekp: kape peak
adlnors: rolands ronalds
aelsss: elsass lasses
ahps: haps psha
afr: arf far fra
aainrst: artisan astrain sartain
einpsu: puisne supine
eeklrst: kestrel skelter sterkel
achrt: chart trach
chit: chit itch
adddelw: dawdled waddled
giprs: grips prigs sprig
clot: clot colt
ai: ai ia
acdellor: carolled collared
adeppr: dapper rapped
aeeimnr: maniere remaine
acdeemr: amerced creamed
dmu: dum mud
dhu: dhu hud
glpsu: gulps plugs
eeimnss: meissen nemesis
adinn: dinan dinna
aeruz: aurez azure
elmny: emlyn melyn
cdeirt: credit direct triced
eeilnssv: evilness vileness
ahkr: hark khar
deill: ellid lledi
aensw: wanes wesna
aersv: avers raves sarve saver versa
div: div vid
cgilnoy: cloying coligny
cginorsu: coursing scouring
egnsu: genus negus
enow: enow owen owne
desy: deys dyes syed
aelrsttu: lustrate resultat
ddy: dyd ydd
adp: dap pad
acelsss: cassels classes
denu: dune nude unde
belmu: blume umble
acegir: graeci grecia
acehlss: chasles clashes
eimrs: emirs miser reims remis rimes
addeemnr: demander redemand remanded
deestw: stewed tweeds
abehrt: aberth bertha breath
deeehst: seethed sheeted
amnuy: mauny yuman
belosw: bowels elbows
aceinn: ancien canine
bnoo: bono boon
deem: deem mede meed
adeeilrs: realised sidereal
adeefr: deafer feared
ehir: heir hier hire ihre
acenst: ascent enacts stance
arst: arts rats star tars tsar
agimnr: arming ingram margin
nsu: sun uns
deilrs: idlers slider
cdeo: code deco ecod
emmno: momen nomme omnem
eeiptt: petite pettie
aaimnr: marain marian marina
acelopt: pacolet polecat
aagnps: pagans spagna
aginstt: stating tasting
aeillsv: savelli vallies
iinossv: visions voisins
cdeer: ceder creed redec
cnoy: cony coyn
adnsw: dawns wands
allsy: sally sylla
emnortt: torment tremont
defsu: feuds fused
filst: flits lifts
eopst: poets poste potes topes
eiklnw: welkin winkle
eimprss: impress premiss
cdelow: colwed cowled
eeny: eeny eyne
hmpu: hump umph
abdeis: abides biased
aehinssttu: enthusiast sustaineth
ddeein: denied indede indeed
aeiinnstu: annuities insinuate
eiilmss: missile similes
deenop: opened penedo
ejosy: josey joyes
aelnpty: aplenty penalty
aeilno: alieno eolian
aeent: anete eaten
deest: stede steed
cdeeirt: diceret directe recited
dlou: loud ould
eiimnrt: interim termini
aeeps: paese pease
denr: dern rend
aaer: aera area
aemny: amney mayne yamen
acepss: scapes spaces
ginow: gwion owing
enorss: serons snores
aeehnv: heaven heavne
acinrs: cairns crains scarin
alpsy: palsy plays splay
adenorv: andover doveran evandro
aeinrst: retains straine
aepst: paste pates peats spate speat tapes
hipsw: whips whisp
adept: adept apted
aelops: aslope poleas
aginprst: partings pratings
aghi: aigh haig
abry: bray raby
eghilns: english shingle
dginy: dingy dying
stu: sut tsu tus
cenortuy: countrey countrye courtney
aadehmmmnos: mahommedans mohammedans
ilos: oils silo soil
ghnorst: sthrong throngs
aehl: hael hale heal
ainpt: inapt paint
aeknsy: skaney sneaky
deeinrsst: dissenter residents tiredness
ceegnorv: congreve converge
aeennrss: ensnares nearness
aeinrv: avenir averni navire ravine vainer
eelst: sleet steel stele
bdenru: burden burned
eoopprs: opposer porpose propose
for: fro rof
binnoors: biornson robinson
ehnort: nother theron thorne throne
acghinpt: nightcap patching
ddeenot: denoted oeddent
ceelrssu: cureless recluses
amrsw: swarm warms
adelopr: leopard paroled
eilort: loiter toiler
doors: doors odors soord
deil: deil eild idle lied
abrs: bars bras
eellrt: retell teller
eemrt: meter metre terme
chrwy: rwych ywrch
isttw: twist witts
adegrr: gerard regard
eostw: owest stowe
denors: drones snored
agnt: gant gnat tang
deiinsst: insisted tidiness
deginr: gerdin ringed
aelpry: parley pearly player
eggilnry: gingerly greyling
derry: derry ryder
abeltt: battle tablet
eilosu: louise soulie
aeirst: satire serait
elno: elon leon lone noel
deot: doet dote tode toed
arsty: satyr stary stray trays
dino: doin doni nodi odin onid
acdegln: clanged glanced
ert: ter tre
ceiklrt: tickler trickle
ciopt: optic topic
eillnst: lentils tinsell
einnost: tenison tension
ilx: lix lxi xli
beeiilmprss: impressible permissible
bor: bro orb rob
aorrwy: arrowy yarrow
aceenrt: caneret reenact
cehiknt: kitchen thicken
emt: met tem
cdeeerss: recessed seceders
adefmr: farmed framed
abelt: blate bleat tabel table
aelx: axel axle
abderv: adverb braved
aehrssw: hawsers washers
aghilnu: hauling laughin
acnor: acorn caron
acels: claes laces scale
answ: sawn snaw swan
bbgimno: bombing mobbing
ittw: twit witt
aeiprsst: pastries piasters piastres
aaeimnnr: armenian marianne
aegirru: aigreur guerira
agirw: gwair wraig
abbdelrs: dabblers drabbles
acdi: acid cadi
ahrst: harts trash
ilw: liw wil
celu: clue luce
aeirss: arises raises serais sisera
aboot: aboot taboo
eelmrst: melters smelter
ailmor: lomira morial
eforsst: forests fosters
hlot: holt loth
ehn: hen neh
adeilsttu: altitudes latitudes
alsy: lays slay
agimrs: gimsar gramis
cfilnot: clifton conflit
beorst: oberst sorbet
ahlt: halt lath thal
ceiopr: copier percio
eiiprt: pietri pretii
ceilu: celui lucie
aclsy: clays scaly
eioprrt: pierrot portier
emnorst: mertons monster monstre
closw: cowls scowl
gnruy: rugyn ungry
benoy: boney ebony
cdi: cid dic
ehilost: holiest hostile
epru: peru pure rupe uper
eerst: erste reset reste seret steer teres terse trees
eeenprst: presente pretense
antuy: atuyn aunty
eehnr: heern herne
eint: nite tien
ceips: epics spice
dnor: nord rond
ejst: jest jets
aekns: snake sneak
aefls: false fleas
eoopprrss: oppressor proposers
deelpy: deeply yelped
deeoruv: devoure overdue
aceil: alice celia
deegirv: diverge grieved
ainort: aroint ration
aeefmnr: enframe freeman
eprstu: petrus purest
aceegils: elegiacs legacies
eorrrs: errors sorrer
elnoy: olney onely
glnny: glynn nglyn
deiltt: tilted titled
aiorsuv: saviour various
abdglno: bagnold bogland
aeerrstu: austerer treasure
aenp: nape neap pane pena
ainqtu: quaint quanti quinta
ddeegrr: dredger gredder
aeehorstv: overhaste overheats
adeginors: grandiose organised
aemru: earum maure
cehrstt: strecht stretch
aorsst: astors roasts
enw: enw new wen
eelps: peels plese sleep
efinr: finer infer
eils: elis iles isel isle lies lise seil
cinossu: cousins socinus
elu: leu lue
chmu: chum much
aenrw: enawr erwan
eilt: elit lite tile
aeisw: ewais waies
acikn: cakin naick
aadilnotu: adulation laudation
oprstu: proust sprout stupor
eilmnr: limner milner
eirstv: rivets stiver strive
degirs: dirges ridges
agiinrs: arising raising
aet: aet ate eat eta tae tea
aerv: aver rave vera
add: add dad
aeilmnr: manlier mineral
efilrt: filter trifle
ddeeinrsu: underside undesired
aalv: alva lava
abesu: abuse beaus
entu: neut tenu tune
eopprssu: purposes supposer
eeprs: peers peres
ehioprsst: prothesis sophister
eekz: ezek zeek
hips: hips pish ship
ainsw: swain wains
depru: dupre perdu prude
abgilmn: ambling blaming
egnrtu: gunter urgent
deilr: idler riled
aainprst: aspirant partisan
lo: lo ol
lostu: lotus soult
ainors: raison rosina soarin
aesy: easy esay yeas
aimor: amori maori mario moira
aeilnv: leavin venial
deeerrsv: reserved reversed
adily: daily lydia
aceinorrsv: carnivores conservari
ahlls: halls shall
hty: hyt thy yth
aimnt: maint matin
aceht: chate cheat teach
ar: ar ra
aelst: laste slate stael stale steal stela taels tales
imt: mit tim
aimty: amity mitya
ceelno: cleone leonce
eprssu: purses supers
aeisst: siesta staies
ailqsu: quails qualis
airs: airs sair
acnny: canny cynan nancy
deinnostu: nonsuited tendinous
ach: ach cha hac
aiss: asis sais
adeinott: antidote ottadeni
aejns: janes jeans
fiorst: fortis fristo
airst: airts astir stair
hilops: hislop polish
aeerrssu: erasures reassure
eessx: essex sexes
adeiilorst: editorials idolatries solidarite
iprst: sprit strip trips
aacrst: carats tracas
aemst: mates meats steam teams
aimst: istam maist
dgiimnoss: misdoings sigismond
einru: inure nuire ruine urien
emorsw: mowers wormes
acrss: crass scars
acenr: crane nerac rance
ikps: skip spik
begin: begin being
gilnow: glowin lowing owling
aghmos: ghosam gosham
ehos: hose shoe
ailmnos: osmanli somnial
admno: damon monad nomad
aenprst: enrapts parents
es: es se
abbnruy: banbury burnaby
dehi: heid hide hied
aiqu: quai quia
dew: dew wed
aeginnot: antigone negation
adeg: aged egad gaed
gostu: gouts gusto
aderrsw: drawers rewards warders
abbir: babir rabbi
bhnorty: brython thornby
ehlstu: hustle sleuth
aeir: aire irae
begilnss: blessing glibness
aainpt: patina pianta
aader: ardea daear
afinr: frain infra
ehinr: henri ihren rhine
deilmnss: mildness mindless
cersttu: curtest cutters scutter
birtu: bruti tibur
eenoprss: esperons reponses response
adeefst: defeats feasted
deentt: netted tented
ahist: saith thais
bho: boh hob
hu: hu uh
bddeir: bedrid beirdd bidder
ait: ait ita tai
ehst: hest seth shet thes
eehsst: sheets theses
adeelps: elapsed pleased
aghs: gash hags shag
cdilu: dulci lucid
acilrtu: claruit curtail
eiirstv: revisit visiter
adegnor: gerando groaned
apr: par rap
aorsw: sowar swoar
ciivx: cxvii xcvii
amnny: manny namyn
adell: della ladle
aell: alle ella leal
lx: lx xl
eefrrs: freres refers
aemn: amen maen mane mean mena name
bginstu: busting tubings
aelnp: panel penal plane
ceehl: echel leech
abdly: badly baldy
belst: belts blest
deilw: elwid wield wilde
efillmor: fillmore florimel
aeltt: latet latte
ill: ill lli
aeipt: patie pieta
kloootu: lookout outlook
eoqu: equo quoe
best: best bets
adehss: dashes shades
acelov: alcove coeval
aeeinnortv: enervation veneration
agnry: angry rangy
aeegmr: meager meagre
cdeenst: descent scented
aahirs: arisha sharia
aelmnrtty: manteltry mantletry
deilnosu: delusion unsoiled
ehilnp: elphin helpin
adey: ayde yade
deinrv: driven vriend
beglu: bugle bulge
eellqu: lequel quelle
adinr: darin drain nadir
aceimn: anemic cinema
eeimn: einem meine
bcelmru: clumber crumble
effi: fief fife
eillr: ellir iller lleir
cdeinort: crediton directon doctrine
adeest: seated sedate teased
eeht: hete thee
adegr: agder edgar egard garde gared gerda grade raged
aett: etat etta tate
ddeei: diede eddie
deenprs: penders spender
loot: loot tool
cemostu: costume custome
aadlnr: ranald randal
aimms: maims miasm
eeprt: perte peter prete
dgir: gird grid
aabdlorr: labrador larboard
eirsstv: revists strives
eeffjry: jeffery jeffrey
bilmnru: milburn rumblin
adgir: agdir graid
dehlru: hurdle hurled
aflo: foal loaf olaf
llwy: llwy llyw
glnsu: lungs slung
alls: llas sall
deilosstu: dissolute solitudes
ahopst: pathos potash
denow: downe endow owned
aegru: argue auger
cemost: comest comets comtes
aelrtt: latter letart rattle tatler
ades: deas eads
aacdnr: cadarn canard
opsu: opus soup
ddery: dryed reddy
dell: dell lled
aeels: eales easel lease
egin: gein geni gien igne
eehinr: herein inhere
ceilmops: complies polemics
bdeer: brede breed
aegn: agen gaen gane
acdeimnos: comedians demoniacs
ghirt: girth right
aeglrty: gartley greatly
adnoru: around nordau
adfiry: fraidy friday
grtwy: gwryt gwyrt
amrt: mart tram
ehistw: whites withes
aals: alas sala
rstu: rust ruts urts
gisw: swig wigs
eflor: forel rolfe
ddegilr: girdled griddle
ben: ben neb
egimnt: meting mignet
alss: lass sals
cory: cory croy
abil: bail bali
ceginnorsv: conserving conversing
akt: kat tak
adwy: adwy wady
deinop: opined pedion
abeks: bakes beaks
acm: cam mac
aegilmnt: ligament metaling
deefilr: fiedler fielder
mssu: muss sums
aeehnrwy: anywheer anywhere
adellu: allude lleuad
ceehny: cheney cheyne
adelsw: wealds welads
abdelr: balder blared
ost: sot sto tso
acginost: agnostic coasting costigan
ccilo: ciclo colic
eny: eny ney nye yen
adeelp: leaped pealed
cehlo: chloe elcho
cgiknor: corking rocking
beer: beer bere
ceiostx: coexist exotics
horstw: throws worths
aeknt: taken tekna
elnrstu: nurstle runlets
aadelmpt: palmated templada
aceklns: clasken slacken
dor: dor ord rod
adeginrst: gradients grinstead
imnoorst: monitors ormiston
deiinorss: derission ironsides
acilopt: capitol optical topical
aelnrt: learnt lenart rental
adeemnnr: mannered menander
bhrsu: brush shrub
agort: argot groat
gory: gory orgy
fhiins: finish fishin
ademsu: amused medusa
deins: denis dines
adeerrv: averred everard
eopt: poet pote
adeprst: departs petards
ceffimnor: moncreiff moncrieff
aclms: calms clams
ailorsty: royalist solitary
epsy: espy spey
cenortu: counter recount trounce
hoosst: shoots sooths
eelrstw: swelter wrestle
acehlst: aletsch chalets latches satchel
acgilnn: glancin lancing
eenrt: enter entre
eehnorsw: nowheers nowheres
ceffio: coiffe office
amnoss: masons samson
aegstuv: gustave vaguest
adginpr: draping parding
aceirsv: sarvice viscera
ceelr: celer clere creel
iost: otis soit
acems: maces scema
bnsu: buns nubs snub
eilsst: islets listes stiles
flru: flur furl
aem: ame eam mae mea
aadnpr: padarn pandar
deimno: domine monied
effssuu: effusus suffuse
aehrt: earth harte hater heart thaer thear
aclm: calm clam
aprss: rasps spars
ceeinv: evince venice
cddeeu: deduce deuced deudec educed
acehrss: chasers chasser crashes
aegimr: marige mirage
eeinnt: niente tienne
acdeeln: cleaned enlaced
eeinrrv: revenir vernier
deimnor: moindre ordinem
aabhitt: habitat tabitha
ckor: cork rock
afo: foa oaf
aaeginrt: aerating garantie
adegilns: dealings leadings signaled
arssty: satyrs strays
ginorsu: rousing signoru souring
acdert: carted credat traced
deginor: groined ignored negroid
aeeimntt: intemate temanite
ailrv: rival viral
dehirs: hiders redish
deint: deint inted
abdeels: beadles bedales
aber: aber bare bear brae
aks: ask kas
low: low owl
cehils: chiels chisel
adelno: loaden loaned
abesst: basest basset beasts
eltt: lett telt
deimnoot: demotion motioned
amnty: maynt mynta
adeir: aider aired deira idear
deglorw: glowred growled
aeginsst: giantess seatings teasings
adeeenrtv: enervated venerated
beino: ebion niobe
emoorrs: roomers rosmore
adeerst: dearest sedater
gmu: gum mug
dorsw: sword words
eeiinnstv: intensive ninevites
aelrsy: layers relays salery slayer
eflorw: flower flowre fowler
deeiirsv: derisive dierveis
anps: pans snap span
abgilnrw: brawling warbling
ceers: ceres scree
abeintt: bettina tibetan
acdeeinorst: considerate desecration
clostu: clouts locust
eimrst: merits mister mitres
adert: dater draet rated trade traed tread
aerssv: sarves savers
iijnn: injin nijni
ehrssu: rushes ushers
aginorrs: garrison roarings
aeemrssu: measures reassume
aadn: adan dana
eikn: enki kein kine
agmnor: mangor morgan
adehr: harde heard
al: al la
defilru: direful fleidur
aeiilmns: alienism milesian
egors: ergos gorse grose ogres sergo
addens: sadden sanded
aeefhrt: feareth feather
eenprs: penser preens
emnoort: montero moreton omerton
dellorst: drollest strolled
eorv: over rove vero vore
acmps: camps scamp
abost: basto boast boats
aeglr: alger glaer glare greal lager large regal
deorstu: detours rousted
ehtty: hetty tythe
enrsttu: entrust turnest
eeinprsstt: persistent prettiness
ceorr: corer corre
innostw: swinton winston
aeils: aisle elias elisa
deew: wede weed
eilrst: lestri litres
adepss: passed spades
aehlv: halve helva
dhlopsu: holdups upholds
aeinorsst: assentior assertion
aehsw: hawes hawse whase
aaeinoprrst: praetorians reparations
begorsu: bourges brogues
adlwy: awdyl dalwy dywal
acinnosst: canonists sanctions
aafghn: afghan afhgan
etw: tew wet
denory: rodney yonder
adeilpt: deplait plaited
chitw: chwit witch
acdnor: candor conrad
flow: flow fowl wolf
adeintt: tainted tendait
aceir: caire erica
deopu: deupo poued
mnoru: mourn munro
bno: bon nob
aelpr: paler parle pearl
adekn: knead naked
ilopst: pilots pistol spoilt
abdor: board broad
filt: flit lift
nosw: owns snow sown
einnst: nestin tennis
ghnostu: gunshot shotgun
eow: owe woe
aelsstt: stalest taslets
aelssv: salves slaves
aceehinoprrst: terpischorean terpsichorean
abdelrw: brawled warbled
celnooss: consoles coolness
deglnu: gulden lunged
ademn: amend named
aaceilln: alliance canaille
eeinrtu: retinue reunite uterine
akms: maks mask
aacdeilno: caledonia laodicean
bdeil: biled bleid
eimnor: merino morien
aeelrsv: reveals several
ceiklnr: clinker crinkle
mu: mu um
deems: deems medes semed
acdelns: calends candles scandel
acortt: cartot cottar
aikl: ilka kail kila
ceersu: creuse recues rescue secure
eiors: osier rosie seoir serio
adeh: haed head
adeinpt: apinted painted
eekrs: esker reeks
deeprsu: desuper perused
aenps: aspen panes penas spane
dginos: doings dosing
mo: mo om
nssu: nuss suns
ehiorvvw: howivver whoivver
adekst: staked tasked
ceil: ciel lice
inov: novi vino
denopru: pounder repondu
dgru: drug grud
adjsu: jauds judas
agiilnt: intagli tailing
eginr: niger reign renig
dry: dry ryd
aaacdgrw: caradawg garadawc
aceemny: mayence mycenae
aceinort: creation reaction
ghinst: nights things
addemns: demands maddens
dgnruy: grundy gundry
aeeknn: keenan nekean
abeehilrsst: establisher reestablish
beimrt: imbert timber timbre
eehmrs: hermes shemer
elrsstu: lustres results rustles ulsters
admu: duma maud
aacelnrst: ancestral lancaster
aehlls: halles hellas
aeilsv: savile valise
deenst: needst nested stende
aess: asse essa seas
deegh: hedeg hedge
aailmn: animal malian
aitv: avit vait vita
io: io oi
ackls: lacks slack
eorsv: roves vorse
beelnoss: boneless noblesse
ceeilnost: elections selection
aagln: alang galan
acehimn: machine meachin
adlnor: arnold landor lardon orland roland ronald
deinst: destin disent
aekst: keats skate stake steak takes
ddenorw: drowned wondred
abghinorr: abhorring harboring
ceenorssv: conserves converses
dnortu: rotund untrod
acprs: carps craps scrap
aaeilllntv: levaillant valtellina
adeirst: astride tirades
acors: oscar sacro
einst: estin inset neist setin stein tenis tiens tines
aceefprt: perfecta praefect
deimor: mordei moried
aadeipprs: appraised disappear
belo: bole lobe loeb
ckors: corks rocks
hnoru: hourn huron
inrtu: turin urtin
aceorsst: coarsest socrates
deiinors: derision ironside
adginot: dinogat doating tinogad
defillr: frilled llefdir
aefir: afire faire ferai
deeflorw: deflower flowered
aeelmns: anselme enamels
adirst: astrid distar triads
inos: nois sion
adeeirst: readiest steadier
deeersv: deserve severed
abiiilmnoost: abolitionism mobilisation
eert: etre reet tree
einprsu: perusin uprisen
acceh: cache chace
acioprst: apricots piscator
eehlrt: helter hertel
eemt: meet mete teem
iltu: luit tuli
adehst: deaths hasted
eemprt: permet temper
abhit: baith habit
aemor: amore romae
deikn: inked kinde
elny: elyn leyn lyne
eost: esto teos toes
dis: dis ids sid
cikls: licks slick
nno: non onn
