ehinrt: hinter theirn
deeimprs: demireps premised simpered
denrsu: nursed sunder
eegnrs: gesner greens
abeglru: glauber grauble
emrry: merry rymer
aagimn: agmina magian
ggiilnnt: glinting tingling
aesu: esau euas suae
eghortu: oughter tougher
loopss: sloops spools
eglorv: glover grovel
aacder: arcade cardea
eeirsv: revise sevier
abek: bake beak
astw: swat wast
elostw: elstow lowest owlets towels
ehisst: sithes thesis
instt: stint tints
aablrtu: labartu tabular
aemnt: manet meant tamen
ceffioru: coiffeur coiffure
lmpu: lump plum
eeersv: reeves severe
agot: goat toga
diinr: nidir ridin
aceilmr: miracle reclaim
acdeilt: citadel dialect
aehmr: harem harme
aaelnprt: parental paternal
hnorsu: hurons onrush
gilnrstu: lustring rustling
aeinrt: retain retina tearin
efi: fei fie
ceorst: corset cortes coster escort tresco
iimntu: initum minuit
aeilnpr: plainer prenial
eent: neet teen
eemort: meteor remote
eeprss: presse sprees
ceehps: peches speche speech
ddenoru: redound rounded
deilwy: dewily widely
almors: morals morlas
egiinsz: seizing zeising
chmsu: chums schum
amorrsu: armours rosarum
ablot: bloat boalt
adenrsw: andrews wanders wardens
bin: bin ibn
eginrs: reigns resign signer singer
eginstt: setting testing
adelw: weald welad
ddeeefnr: defender defendre
eeinsv: envies venise
aceeps: escape espace
horsu: horus hours
aadglnrs: garlands raglands
ainoort: ontario oration
aglu: gaul gula luga
ellovy: lovely volley
elw: lew wel
abdir: baird braid rabid
aegnrr: garner ranger
acepr: caper crape pacer parce
derw: dewr drew
acehlrs: charles clasher erchlas larches
fou: fou ufo
aillnst: install stallin
aelmnor: almoner normale
aegr: gaer gare gear gera rage
ddegil: gilded glided
aagm: gama maga
tu: tu ut
behmo: boehm bohme
acess: cases cessa
acly: clay lacy
ciiix: cxiii xciii
eilms: limes miles selim slime smile
aeemnssttt: statements testaments
abeirrs: braires brasier rabiers
ahnno: anhon hanno
cei: cie ice
aehlrty: earthly hartley
acdls: clads scald
aeehnrt: earthen hearten teheran
aailrt: lariat latria
abeilmst: balmiest semblait
eirst: rites tiers tires treis tries
abeiilnort: libationer liberation
aemsty: mayest steamy
ailov: viola voila
acnstu: cantus tuscan
ainsst: saints satins stains
ghsu: gush hugs
acddeennst: decendants descendant
aemrsstt: mattress smartest
aeilns: aliens saline selina
beghinorsu: bringhouse neighbours
eeinnr: reinen rennie
cdeiinoprst: description predictions
acehrs: arches search
inoprss: porinss prisons
aeefir: faerie feriae
ammsu: musam summa
airsstt: artists straits
eoprstt: potters protest
cehirs: chersi riches seirch
llnu: llun null
enoprst: postern preston
aeht: aeth hate heat thae
aegilnt: elating genital
elnot: elont elton
adelrs: alders sadler
ailmtu: latium ultima
eimoprs: imposer promise
ceilnst: clients stencil
glssuy: gussyl gyssul
eeeirrtv: retrieve terrivee
abdeinot: obediant obtained
adenpp: append napped
dow: dow owd
ellw: llew well
acdeersst: descartes sacredest
cdeeinorrs: considerer reconsider
arstw: straw swart warst warts
cehhi: chieh heich
enoos: noose soone
ahsw: haws shaw wash
fhirst: firths shrift
amorr: armor marro
acnoort: cartoon crotona
eilorst: loiters toilers
cnoorstu: contours croutons
ehors: horse shore
adeggt: dagget tagged
egnor: ergon goner groen grone negro regno
dily: dyli idly idyl
deopr: pedro pored roped
eghot: goeth theog
aemr: eram mare
bersu: rebus urbes usber
aeinrtt: intreat nattier tertian
acilsv: cavils slavic
einprs: ripens sniper
lossu: solus souls
adilv: valid vidal
hsu: shu suh
eeelssy: elysees eyeless
cdu: cud duc
aclps: claps clasp scalp
ceelrstu: cruelest lecteurs lectures
adems: dames meads
adinrw: darwin drawin inward riadwn
bruy: bury ruby
enort: notre tenor trone
ehillms: himsell mellish
akl: kal lak
deefnr: fender freden
aost: oats sato toas tsao
agiknst: skating staking takings
bdeerssuv: subserved subversed
amtu: muta tuam
ceehnsy: cheneys chesney
aikmn: makin manki
acnno: canon conan
aceert: cetera create
aaciinnnostt: incantations inconstantia
acdelps: clasped scalped
eeerrsv: reserve reveres reverse severer
cepry: percy precy
amt: mat tam
eellsw: llewes sewell
adflu: fauld fulda
adeemnoru: demeanour enamoured
deiorst: editors storied
ceenrt: center centre recent
deenrr: render rendre
eenopr: opener reopen
eilnosw: lewison winsloe
lsy: lys sly syl
ablw: bawl blaw
ehmrsu: musher rheums
hiosu: huios uhios
aeemnptv: pavement paventem
agnot: tango tonga
aeglor: argoel galore gaoler
aelms: leams males meals salem
eeprst: pester peters septer
aaln: alan alna
iln: lin nil
acdeelr: cleared declare
deenrss: redness senders
amnoz: manzo monza
airsst: astris stairs
ceeorrsu: recourse resource
beors: boers bores robes sober
aeinprst: painters pantries pertains
eisssu: issues suisse
eisvw: views wives
aaghmr: armagh graham
elmors: morels morsel
aeerstw: sweater wearest
eiqtu: quiet quite
eilnw: elwin welin
efinors: forensi inferos
ademnrsu: maunders surnamed
ceoprss: corpses process
aeehilsttw: wealthiest whittlesea
acellopss: collapses escallops
dilos: idols soldi solid
dgiilns: sidling sliding
deeilr: delire relied
eemss: messe seems semes
ajm: jam maj
chinop: chopin phonic
abeert: beater berate
bgi: big gib
ely: ely lye
adil: dial laid lida
cdeir: cider cried dreic
eeinrt: entier entire
addeelp: pedaled pleaded
acdet: acted cadet
berv: bevr verb
bnortu: bruton burton
eeinoprs: pensiero pioneers
aeins: aisne anise siena
aiilmnosttu: mutilations stimulation
ansu: anus naus suan unas
einstv: invest ventis
adeerrst: arrested serrated
aacelpt: placate placeat
aeilmnrst: terminals tramlines
illt: lilt till
fgiilnrt: flirting trifling
acehl: chela hecla lache leach
aceennortv: contravene covenanter
aeemnsttt: statement testament
ainv: avin ivan vain
adeln: alden andle laden
deors: doers sedor
cho: cho hoc och
abdeelrss: beardless breadless
enop: nope open
abkl: balk kalb
acginnoot: cognation contagion
elosu: eolus louse
eiknrw: wirken wrekin
emnos: omens omnes
aelstt: latest taslet
adw: daw wad
deerstw: drewest strewed wrested
eelny: elyen neely neyle
aprst: parts sprat strap traps
adls: lads sald
bikrs: birks brisk
aelnr: larne learn
cdeefiirt: certified rectified
einrs: reins resin rinse risen siren
loops: loops pools sloop spool
dehnsy: shendy shyned
acdehr: arched cheard
deginnr: grinned rending
ddehiny: dihenyd heiddyn
abcel: cable caleb
accersu: accrues accuser
eorstv: strove voters votres
elpst: pelts slept spelt
aeioorrst: oratoires oratories
aglno: along logan longa
aips: apis ipsa pisa
apy: pay yap
accdehrst: scatcherd scratched
einorss: seniors serions
ajnos: jason jonas
ivxxx: xxxiv xxxvi
acins: canis casin incas
adrt: dart drat tard
iklm: klim milk
agiilnost: intaglios isolating
grw: gwr rwg
aegillnrv: granville ravelling
aehrss: shares shears
denorstu: roundest tonsured unstored
notw: nowt town wont
eenstv: events steven
eilx: exli ilex
eehiprt: perheit prithee
beeln: belen leben
ainps: pains pisan spain
aceflnot: cleofant falconet
aelsty: astley slatey
eekn: keen knee neek
aeiprst: parties patries pirates
aceginnors: coarsening ignorances
aeehirst: hearties theresia
cehinor: eichorn henrico
aabl: baal bala
aennotu: enouant tonneau
alssu: lassu sauls
ejstu: juste sujet
accehimns: mechanics mischance
cdo: cod doc
nstu: nuts stun sunt tuns
acddeiinot: dedication eddication
aenoprs: operans pearson persano persona
acitt: attic citta tacit
ghu: hug ugh
ehistt: thetis tithes
eorst: roste sorte store
enrst: rents stern
amrst: marts smart trams
achin: achin chain chian china
fist: fist fits sift
eilmss: selims smiles
adeeln: delane leaden leaned
agrt: gart grat
iimnnos: minions nominis
degiinrtu: intrigued nigritude
elosvw: vowels wolves
aehns: ashen hanes
eorrst: resort torres
cehnnosu: nonesuch unchosen
alry: lary lyra
beehst: behest thebes
deeotv: devote vetoed
ahmnu: human nahum
elos: lose sole
acep: cape pace
deioprsv: disprove provides
einvy: veiny viney yvein
adeilt: detail dilate tailed
eglnosu: longues lounges
gilno: lingo login
aceennrst: entrances renascent
acehnsstt: snatchest stanchest
nor: orn ron
belorsst: bolsters lobsters
eersv: serve sever veers verse
aghirt: aright arthgi graith
anr: nar ran
aeegilnrs: algerines releasing
ehrs: sehr sher
deeinrst: inserted resident
abeeilmst: estimabel estimable
adelpr: pedlar predal
deenopr: pondere reponde
acderv: carved craved
deikln: kindle linked
egglru: gurgle lugger
bsstu: busts stubs
degiinnnt: indenting intending tidningen
aabcdkrw: backward drawback
eeginrt: gereint greetin treeing
eimpstu: impetus stumpie teipsum
elpruy: purely purley
ceorss: corses scores
eopprst: opprest stopper
deeeintv: eventide evidente
aegimn: enigma imagen
aeginw: gwanei gwnaei
aeqrtu: quarte quatre
abdu: buda daub
aemrsst: masters streams
eersy: yeers yeres
eprsu: purse super
nru: run urn
hot: hot oth tho
acrru: crura cuarr
aeginors: organise soignera
aehrty: earthy hayter hearty thayer
efnoosst: eftsoons festoons
aabb: abba baba
aejn: jane jean jena
hint: hint nith thin
aberstw: brawest wabster
aeirrss: raisers sierras
cdeostu: custode scouted
chior: choir ichor
belmrsu: rumbles slumber
aegss: gases gasse sages
bekoo: booke ebook
egr: ger gre reg
aehly: haley helya hylae
cehir: erchi riche
de: de ed
cdeirstu: curtsied discuter
aabcimr: cambrai cambria
deeinss: dessine essendi
chinst: nichts snitch
noy: ony yno yon
elmy: emly lyme
aceghr: charge creagh
eopr: pore rope
beirsu: bruise buries busier rubies
cehz: chez zech
abers: baser bears braes sabre
aeehrt: heater reheat
eorrrst: storrer terrors
aenrstv: sarvent servant taverns
aaeimrst: amiserat maestria
eoru: oreu oure roue
egiimmnrs: immersing simmering
abehrst: barthes bathers breaths
abemr: amber bream
eilltt: littel little
aabdor: aboard abroad
beilorr: broiler orrible
bdeeginr: beringed breeding
adeeimnoprst: impersonated predominates
ceerss: recess screes
aelmnst: laments mantles
addeemn: amended demande
aeehprs: phearse reshape
aehnsy: haynes hyenas
ginrs: grins rings
adeinostt: antidotes stationed
hinntu: huntin nuthin
aelmnt: lament mantel mantle mental
cdehir: chider rechid
hir: hir ihr rhi
aalmt: malta talma
adiw: idaw wadi
deow: odew owed
eensy: esney syene
ortu: rout tour
eenprsst: pertness presents pressent serpents
eeillrv: lleveri reville
eflry: ferly flyer
bery: byre ebyr
eiklst: kleist likest
beeentw: between betwene
aegimnrst: emigrants mastering streaming
abdry: brady darby
cdeiorrt: creditor director
aehisstt: atheists hastiest
aimnsu: animus simanu
alp: alp lap pal
adev: dave vade
deo: deo doe ode oed
abilr: blair libra
eeiinprs: inspiree pineries
adefil: afield failed
bcehrstu: butchers schubert
epry: prey pyre
einprrt: printer reprint
adefry: defray frayed
ehilt: ithel leith lieth lithe
bdeortu: obtrude redoubt
ceenrst: centers centres
aderrst: starred traders
adeegnrs: grandees grenades
delosw: dowels slowed
ahirstw: watrish wraiths
adeelrs: dealers leaders
aegmru: mauger maugre
eiku: keui kuei
alnot: talon tonal
aabillnost: bataillons batallions
abeirrst: arbiters rarebits
bdeisu: busied diebus
deinru: indure inured reidun ruined
dehinosst: dishonest hedonists
bsu: bus sub
ahns: hans nash shan
aadhims: maidahs shimada
beeillnors: rebellions serbelloni
adl: dal lad
eilv: evil levi live veil viel vile
deeepst: deepest deepset steeped
arx: arx rax
eoprs: pores poser preso prose repos ropes soper
amnorst: marston matrons monstra transom
aegilns: leasing sealing
blot: blot bolt
alors: alors solar
egmnoortu: montrouge rougemont
abdnru: dunbar durban
amot: amot atom moat
aaeinoprrt: praetorian reparation
eghitw: gweith weight
efnost: sefton soften
cosw: cows scow
aehnst: athens hasten senath
adeenrrstuv: adventurers untraversed
alosv: ovals salvo
enu: neu nue une
behnrtu: burneth burthen
asty: asty stay
deeinr: denier nereid reined
ceikpst: pickets skeptic
eemry: emery meyer
hortt: thort troth
elmnot: melton molten
deiost: edisto editos
aeimnr: armeni marine remain
aey: aye yea
aenprt: entrap parent
aceerrst: caterers terraces
aacilr: alaric racial
egm: gem meg
deetw: tewed tweed
abeins: baines sabine
achins: chains chanis
inst: inst sint tins
aehhrsst: harshest thrashes
dehor: herod horde rhode
aehmrs: harems hermas masher
acdeeilmr: declaimer reclaimed
aeimn: maine menai
abdilr: bridal ribald
bellosw: bellows boswell
aegnntt: gannett tangent
adhmmno: hammond mohmand
ceeiorst: coteries esoteric
enoz: onze zeno zone
adims: maids midas
acimno: monaci monica
aftu: faut tufa
ehlrtu: hurtle luther ruleth
aehnt: ethan neath thane
cir: cir cri
dhinu: dihun hindu
bnru: brun burn
eopprss: oppress propses
dintuy: nudity untidy
ceeips: pieces specie
imnoors: morions morison
ahirs: hairs ishar
abdehorr: abhorred harbored
densttu: student stunted
dein: dine edin enid inde
deorstw: towerds worsted
eiopss: poises posies seipso
ggilnos: glosing gosling
cefor: corfe force freco
blost: blots bolts
adeknr: danker darken ranked
aelnpu: laupen nepaul
brtu: brut burt
irstw: wrist writs
acdeinotu: cautioned education
abel: abel bale beal elba
cderstu: crudest crusted
eoopprss: opposers proposes
bist: bist bits
belmstu: stumble tumbles
aelp: leap pale peal plea
ailns: nails slain snail
aesttu: astute statue
deooprt: torpedo trooped
eorrsst: resorts sorters
eelsty: sleety steely
eehprs: hesper sphere
aelqsu: equals squeal
agsw: gwas swag wags
eeln: elen nele
adeilort: idolater tailored
aeeprss: parsees separes
deu: deu due ued
cddeinostu: deductions discounted
air: air ira
ceilnu: lucien nuclei
abceirs: ascribe brescia
ekrs: kers resk
loost: loots stool tools
cddeeer: decreed receded
orstw: strow trows worst
deprsuu: pursued usurped
aailv: avail avila
acnost: actons cantos costan sancto
abdelst: baldest blasted stabled
cgiinnoot: cognition incognito
aeenst: santee sateen senate
adeeginrr: grenadier rereading
acegil: celaig gaelic
ehmr: herm mehr
ceir: crei eric rice
cdorsu: codrus crouds
aiins: ainsi sinai
eilrv: liver viler
adeeglnnr: englander greenland
aekrs: akers arske rakes skare
cinost: tocsin tonics
deeefr: feeder reefed
deinns: dennis sendin sinned
acdeg: cadge caged
allnw: llanw llawn
aaceiimnrsst: cartesianism sectarianism
aaillt: allait atilla
abklu: baulk kalbu
ilsst: lists slits
deiopr: period proide
eemn: meen neem
aceilors: calories escorial
cehors: chores roches
glpu: gulp plug
cersw: crews screw
achmr: charm march
eijnor: joiner rejoin
celnosu: counsel unclose
eegr: geer gree rege
dopr: drop prod
aglou: golau logau
aehors: ashore hoarse shoare
aehrtt: hatter threat traeth
inp: nip pin
ix: ix xi
addehs: dashed shaded
acdehnor: anchored headcorn
cenorrs: corners scorner
aacnnovw: annovawc anvonawc
adelry: darley dearly
abent: beant benat
dehiss: dishes hissed
adeil: ailed delai delia ideal ladei ladie
deinsty: density destiny
deny: deny enyd
abbe: abbe babe
eimt: emit item mite time
eeimmor: memoire memorie
aekls: lakes leaks slake
eloppt: opplet topple
efgiinnr: infringe refining
efrry: ferry fryer
hlmo: holm mohl
il: il li
elors: loser roles
egnoy: goyen yonge
corsu: cours scour
deoprstu: proudest sprouted
addegimnn: demanding maddening
crstuy: crusty curtsy
ceerrtu: creetur creture
eerwy: weery weyer
aeeinnrtt: entertain tarentine
aenors: reason senora
egnorv: govern vergon
dipr: drip prid
eknnow: knowen knowne
eel: eel lee
deoty: toyed ytoed
ainst: saint santi satin stain
eellsy: lesley sleely
beelr: bleer rebel
oy: oy yo
aeeglmry: meagerly meagrely
aglop: galop ploag
ainops: pianos pisano
eenrw: newer renew werne
eirvv: ivver vivre
ilvxx: lxxiv lxxvi
eelrsstt: settlers trestles
ahmrtw: mawrth warmth
bde: bde bed
dooru: douro odour
eghhist: eighths heights highest
aiost: ostia tiaos
dnowy: downy wodyn
egilnt: gentil tingle
acginr: caring racing
aegst: gates stage
aefirs: faires fraise
ehorrt: orther rother
ersu: rues ruse sure user
beinr: brein brine erbin
deissu: disuse issued
cdeenortu: countered recounted
egillnov: gonville livelong
addeehnr: denderah hardened
eeginssu: geniuses gesseuin
ginw: gwin wing
ffist: stiff tiffs
aenoprsst: patroness transpose
aelmns: anselm lemans
adeginrt: gradient treading
acdehmr: charmed marched
aceghiloorsst: archeologists astrologische
aelprst: plaster psalter
ceorsst: corsets escorts
cdei: dice iced
aeglnr: angler nergal rangle
aelsst: slates steals tassel
aesstv: savest staves
aeinprt: painter pertain repaint
ef: ef fe
bbdemo: bombed mobbed
aacghillpry: calligraphy graphically
eopprrs: propres prosper
eeilrv: reveil revile
bostu: bouts buost
acemnor: cameron cremona romance
eiknprs: perkins spinker
aaeehkprss: shakespear shakspeare
adegginnr: deranging gardening
aehippst: epitaphs happiest
ailmrstu: altruism ultraism
deerssu: duresse rudesse
aegu: ague guae
ceert: crete erect
aillsv: vallis villas
iv: iv vi
essu: sues uses
eeimnnoprst: montpensier omnipresent
achr: arch char
aclnuy: lunacy unlacy
aeilnst: eastlin entails salient
ainnot: anoint nation
fils: fils flis
acehimnors: harmonices monarchies
beopr: pobre probe
aeoprssv: overpass passover
elnost: solent stolen stonel
ddeent: dented tended
agt: gat tag
aeirsv: servia varies
ains: ains nais
ceinnnost: continens innocents
aor: oar ora
ginnooppst: postponing soppington
clo: clo col loc
aeggnr: gagner ganger grange
aells: llaes lleas salle
ceefprt: perfect prefect
aeelpr: parlee pearle repeal
adeilst: details dilates
aotu: aout auto
cmu: cmu cum
aelnry: nayler nearly
deinrtu: intrude untired untried
aswy: sway ways yaws
aikt: kait taik
defnor: fonder fronde
aabdhkrs: shabdakr shabkadr
dddeil: diddle lidded
eehrw: hewer wheer
eiloprsu: leporius perilous
acelp: capel place
aenn: anne enna nane
cehin: chein chien chine niche
abst: bats stab
aamrt: marat tamar
aagilmnr: alarming marginal
egnow: gowne ogwen
cdeeer: cedere decree recede
acehsst: chastes sachets scathes
cdeiinorst: directions discretion
egistw: getwis gwesti
aenst: nesta sante stane stean
ahlloo: halloo holloa
imnos: minos moins monis simon
ennwy: wenyn wynne
adnou: adoun danou nodau
aeilnort: oriental relation
gil: gil gli
cehrt: recht retch
aegiinnprt: pertaining repainting
eefilr: elifer relief
elov: love vole
dlorwy: wordly worldy
aanty: ayant tyana
aepr: aper paer pare pear pera prae rape reap
demno: demon medon monde
achiort: chariot haricot
adelp: paled pedal plead
addeprs: despard padders
accdekl: cackled clacked
adeelrrstu: adulterers serrulated
aelny: anely enyal eylan layen layne
clost: clost colts
ennosv: venons venson
cghinrsu: crushing ruchings
ry: ry yr
eeimmors: memoires memories
aikort: rakoti troika
esuz: suez usez uzes zeus
aceilmrs: claimers miracles reclaims
agiu: aigu guai
eerstt: setter street tester
eenst: teens tenes tense
achpt: chapt patch
eisv: ives sive vies vise
aim: aim ami mai mia
acdeps: scaped spaced
abosst: boasts sabots
ahrtw: thraw wrath
egrry: ergyr gerry
aainrt: ariant tarian
eopss: poses posse speos spose
afirr: frari friar
adinstt: attinds distant
aoprru: pourra uproar
losu: luso soul
aeginrs: erasing gainers sagnier searing sergian
acde: cade dace deca
aloprst: patrols portals
aacinotv: vacation vaticano
adefr: fader fared
denor: drone endor odren roden
aenrst: antres astern senart serant
ceiorrstu: courtiers scrutoire
cdeinortu: introduce reduction
eilnn: linen linne
belostt: bottles stobelt
adeilpsttu: platitudes stipulated
aestw: sweat waste
eosttu: outset toutes
aglo: gaol goal lago
aelmrs: larmes marles masrel realms
eemrsu: mesure resume
abit: abit bait bati
aacnorstt: atcorsant transacto
aegln: angel angle galen glean
lmotu: molut multo
eilss: isles liess
deilp: piled plied
anortu: auront outran
acdent: canted cedant
cor: cor ocr
ahost: athos oaths
emnsu: menus nemus
aknr: karn nark rank
ahmnopt: hampton phantom
ailr: lair liar rail
afit: fait fiat
eill: ille leli
aagimnor: mingaora morgiana
eekps: keeps speek speke
amrw: marw mawr warm
aegrv: gavre grave
eopsy: poesy posey sepoy
akprs: parks spark
deerrss: dresser redress
aenoprst: paterson reposant
aeegnrsst: greatness sergeants
agnnry: granny gynran
afst: fast fats
emnoy: money moyen
celrttu: clutter curlett
eorsstu: rousset trouses tussore
dsstu: dusts studs
aelmny: laymen manley meanly namely ymlaen
dfmorru: murford rumford
adeimrr: admirer married
deegs: edges sedge
elru: leur lure rule
efrt: fret reft
aenoopsst: soapstone teaspoons
bdeirs: brides debris
ceeiknst: eckstein neckties
eelr: erle leer reel
adelms: damsel medals
dehrs: herds shred
aeeiilrsst: israelites isrealites
aehmrt: mather mehtar
amnors: manors ransom romans
deor: doer dore oder rode
chiorst: chorist christo ostrich
bop: bop pob
beerw: ebrew weber
einrssu: insures sunrise
aginr: agrin grain
arv: arv var
eeiillnssv: liveliness livlinesse
adeginos: agonised diagnose
aceilrt: article recital
eeiqrtu: quieter requite
cdlo: clod cold
dggiiln: gilding gliding
hrsu: rush shur
bdgiilnr: birdling bridling
ahlloty: loathly tallyho
adeils: ideals ladies sailed
deiopst: deposit posited
aeeglmnnt: gentelman gentleman
acilnosv: consalvi slavonic volscian
illst: still tills
eip: epi pei pie
acggilnn: clanging glancing
adeellrsw: darewells swallered
ilny: inly lyin
bcistu: cubist cubits
abdrs: bards drabs
abdelm: ambled bedlam blamed
bemor: brome omber ombre orbem
aegnst: agenst agents sanget
llsy: llys syll
aenorv: orevna verona
eintv: venit venti vient
llrwy: llwry llwyr
abekl: blake bleak
orsttu: trouts tutors
belrstu: bluster butlers subtler ulbster
eeorrtuv: overture retrouve
attu: taut tuat
eiops: opies poise
aehrs: hares hears share shear
adeioprs: parodies rapsodie
aekms: kames makes
egilns: elgins single
aclns: clans lancs
deorrs: orders ordres
eghirt: erthgi reight
cdegiinrt: crediting directing
bdenorsu: bounders rebounds
addelw: dawdle waddle
aachmnp: chapman pachman
aeln: lane lean lena neal
deiw: edwi wedi wide
eeilt: eitel elite
eiorrv: revoir verrio
dginoorw: ringwood woodring
beeikl: belike keebil
ehno: hone ohne
ceghinpr: perching preching
deeelr: leered reeled
aenor: aeron erano
acills: lilacs scilla
aeh: hae hea
acdis: acids sadic
acessu: causes sauces
celos: close coles
deenprt: perdent pretend
eimnost: moisten temoins
cenorw: corwen crowen
ceenorsv: conserve converse recevons
deeps: deeps speed
aekw: wake weak
aacfinrs: africans francais
adhlor: haldor harold
ckstu: stuck tucks
acdehnst: snatched stanched
illsy: silly slily
ceilnorsu: cornelius inclosure
aelnrv: navler vernal
eeginnu: genuine guienne
eimst: emits items mites smite times
beill: belli libel
aglss: glass slags
aerssty: estrays stayers
egiinnpr: repining ripening
orw: row wor
einr: neir rein rien
airv: ravi riva vair vrai
llorst: stroll trolls
aemrstu: matures remusat
deiins: indies inside
acinnot: connait contain
ggosy: soggy ysgog
acnop: capon copan
cdsu: cuds scud
ehtwy: whyte wyeth
defrru: furder furred
ekly: kyle lyke
ceikqstu: quickest quickset
ceeinnoorrt: reconnoiter reconnoitre
cikst: stick ticks
ademor: medora roamed
eefgiln: feeling fleeing
anov: avon nova
aelrstv: travels varlets
ivxx: xxiv xxvi
eeimns: meines seemin
acot: cato coat
ainstt: statin taints titans
aoprst: pastor patros
aadegnr: gardane grenada
acilmnopt: complaint compliant
bbelru: lubber rubble
bdeor: bored orbed robed
deopsu: pseudo souped
aginnw: awning waning
ceiiopprstu: percipitous precipitous
eorss: orses roses rosse sores
gilny: ligny lying
aeemnorsuv: manoeuvers manoeuvres
bdelott: blotted bottled
dils: lids slid
bdeginort: bridgeton gondibert tonbridge
abell: bella label
epprssu: suppers suppres
deghilt: delight glideth lighted
eiirsstv: revisits visiters
emnort: mentor merton montre
egov: gove oveg voge
deirt: erdit tired tried
abelrt: albert barlet bartle
acehlnsu: chaulnes launches
einsv: nevis veins viens vines
aginst: aginst gainst giants
aersy: ayers ayres rayes sayre years
anry: nary ryan yarn
ilnott: lintot tilton
aeft: fate feat
ory: roy yor
ailsu: luisa usial
aw: aw wa
adorru: ardour dourra
ciiivx: cxviii xcviii
delru: ledru lured ruled
adist: adits adsit staid
aadelmr: alarmed delamar
ahw: haw wha
eipsw: swipe wipes
bjo: job obj
abm: bam mab
opstt: potts stopt
aelrssy: rayless slayers
adegnrs: dangers ganders gardens grandes
aeijm: jamie majie
abdehit: abideth habited thebaid
ginost: ingots stingo
aennrt: antern tanner
eginor: ignore origen region
epsst: pests steps
mop: mop pom
aeloprst: palestro patroles
aghilnss: lashings slashing
dgo: dog god
eefinr: fernie refine
aikn: akin kian
adginru: gaurdin guardin
now: now won
deflno: enfold fondle
adeflr: alfred fardel flared larfed
acel: alec cela lace leca
abnos: banos bason
adekr: darke drake raked
ilt: lit til
aelprstt: platters prattles
acghinr: arching chagrin chargin charing
aagnorrt: arrogant tarragon
aeelpss: elapses pleases
aellssw: lawless sewalls
iiilvx: lxviii xlviii
eil: eil eli ile lei lie
aeghnr: anrheg hanger
abrsy: brays byrsa
crtu: curt turc
eefhrsst: freshest freshets
eeinrsv: inverse severin veneris
cdeehipr: ciphered decipher
cdeeiirstv: directives discretive
oort: root troo
delos: delos doles
eprs: pres reps
aew: awe wae
eoprst: poster presto topers tropes
acef: cafe face
noty: tony tyno
ehirstw: withers writhes
efhilms: flemish himself
inprtu: turnip turpin
cilo: clio coil loic
eimrss: misers remiss
ginsw: swing wings
agilr: grail ligra
cehisv: chives veschi
nosu: nous onus
aaeilrss: salaires salaries
beffrsu: buffers rebuffs
eeemsst: esteems seemest
ehimrt: hermit mither
adefiors: ardesoif foresaid
aaiknnnu: annunaki anunnaki
aelnrs: larens learns
amsw: maws swam
aceeinrt: certaine increate
envy: envy nevy
aghinrs: garnish sharing
adeors: adores soared
eilmntuy: minutely untimely
cimno: cimon comin
eegnr: genre green regne
lvx: lxv xlv
bdegilo: oblidge obliged
aiprty: pairty parity
eilst: islet liest liste stile tiles
emops: epsom mopes poems
aert: ater atre eart erat rate tare tear
giinpps: pipings sipping
eikp: kepi pike
ccdeir: cedric cerdic
aeeglnrs: enlarges generals gleaners
ilnstu: insult sunlit
addemn: damned demand madden
aflot: aloft float
inors: irons noirs rosin
dstu: dust stud
aehlt: ealth lathe
adr: ard dar dra
aekmrs: makers masker
enss: ness sens
deglor: golder lodger
acefhlns: flanches flaschen
lnoos: loons solon
eilnpp: lippen nipple
abdegir: abridge brigade
deeirsst: desirest resisted
ho: ho oh
hrtu: hurt ruth
acelns: lances senlac
ccorsu: crocus occurs succor
aerstu: atreus auster autres
eoorstt: tooters trooest
aaeimnt: animate emanait
chlru: churl lurch
aeiprt: partie pirate
eeknu: keneu uneek
abdeo: abode adobe
deeilnst: enlisted listened
aeoprs: operas pesaro sapore
chnor: chorn chron
bennot: benton bonnet
ehit: heit hite
deelv: delve vedel
acdeilst: citadels dialects
iorst: riots sorti trios trois
elm: elm lem
emr: mer rem
bchu: buch chub
anorry: ornary raynor
below: below elbow
nort: torn tron
mmu: mum umm
