aimprst: armpits imparts
eeffjrsy: jefferys jeffreys
abeelmss: assemble beamless
acdellops: collapsed scalloped
acddein: candide candied
abcehmr: chamber chambre
diov: dovi ovid void
eikln: elkin kline liken
aamnt: amant amnat
ceilort: cloitre cortile
cenort: contre cornet
eilrvy: livery verily
egrsu: segur surge urges
eopprr: proper propre
bdemoors: bedrooms boredoms
dego: dego doge gode
delo: dole lode olde
eelrv: elver lever revel
adir: arid raid
art: art rat tar tra
adlrw: drawl warld
aklsw: lawks walks
adeemnr: meander renamed
ehorst: others throes
aehlmt: eltham hamlet
eeinv: envie viene
aceilrst: articles recitals
abdels: blades sabled
defr: dref ferd fred
aehrst: earths hartes haters hearts sarthe
aceno: canoe coena ocean
ademnru: manured maunder unarmed
aacinr: aranci arnica
ceiiorstv: victoires victories
eeeglmnn: genelmen genlemen
aegilv: glaive vilage
ah: ah ha
acersu: causer saucer
aehimpssty: sympathies sympathise
befirs: briefs fibers fibres
beehnrrt: brethern brethren
eehrvy: hervey hevery
adeimn: demain madien maiden median
ghiintt: hitting tithing
aimno: animo moina omnia
adeht: death hated
ceeprs: creeps crepes
ddegir: girded ridged
ostu: oust outs tous
imruv: rivum virum
aceelrst: alcester clearest
aclt: clat talc
devy: devy yved
egiilnnst: enlisting listening
eeinrst: entires entries sentire teneris
ehy: hey hye yeh
acor: caro cora
aeilmss: aimless melissa
abdeorr: abrorde boarder bordera broader
eluy: uley yule
aeeinprt: aperient repeatin
aeegilnnt: eglantine inelegant
illy: illy lily
aegnrst: garnets sargent strange
emsswy: wemyss weymss
acost: ascot coast coats costa
eforrst: forrest forster
bceklu: buckle lubeck
eos: eos oes soe
aehlsst: hasselt hatless
adginor: adoring gordian
eilps: piles plies spiel spile
deg: deg ged
aeehlrt: erhalte leather
abilno: albino albion
ehoorst: shooter soother
ammstu: summat tummas
deilmp: dimple limped
eglov: glove vogel
beglo: bogle globe
eeimrr: mereri merrie
adelru: lauder raudel
aelps: lapse leaps pales peals pleas
acenrt: canter cretan nectar recant trance
acinoss: cassino scioans
deeemr: redeem remede
eiinrv: irvine virein
aensv: evans vanes
aafilpry: fairplay playfair
illps: pills spill
deeimrt: demerit merited
eeforrst: foerster forester fosterer
dhnosu: hounds hudson unshod
acennotv: conventa covenant
aelprtt: platter prattle
degiimnp: impeding impinged
annos: annos anson
ailmort: mortali mortial
aefr: afer fare fear fera frae
aenrsy: raynes yearns
abdny: bandy danby
denru: rendu under
egiilnrv: reliving reviling
eortw: tower worte wrote
abgr: brag garb grab
adelsv: salved slaved
cdehry: edrych erchyd
rsttu: rutts strut trust
einsst: insets steins
imopst: impost impots
aeiknt: aitken intake
deiosuv: devious evodius
afgimnr: farming framing
aailprt: parlait partial ripalta
amoty: amyot atomy
aegnrw: aergwn wagner
aer: aer ear era rae
ginorw: growin rowing
pstu: puts supt
aeilrss: airless laisser serials
beilrsst: blisters bristles
eostv: stove votes
adehir: haired hardie
deestv: devest vested
afikr: fakir kafir
boss: boss sobs
agrs: gars rags
ahirst: hairst ishtar
acdeilm: claimed declaim medical
hins: hisn hsin shin
dgilno: doling lodgin olding
adiimnnoost: admonitions dominations
aenort: atoner ornate
ddeot: dodet doted
aelmprs: palmers sampler
adlno: donal lando
aehirtv: vaither vraithe
hnort: north thorn
moort: morot morto motor
abeils: blaise isabel
artw: tarw wart
ddeiit: edidit tidied
ixx: xix xxi
ademt: mated tamed
dost: dost dots
ae: ae ea
dot: dot tod
ahpst: pasht paths
amru: amru arum maur raum umra
aelrstt: latters rattles startle
eenrtv: venter ventre vernet
adisv: davis divas
ddowy: dodyw dowdy
aessy: essay sayes
emtt: mett temt
aeensv: eavens neaves
eirssst: resists sisters
aafr: afar afra
ceehlprssu: sepulchers sepulchres
aprsw: warps wraps
aahps: asaph pasha
eprt: pert pret
egru: greu urge
aeelmnss: lameness nameless salesmen
aerrs: rears serra
aemnrt: marten mentar
ahrstwy: arthwys athrwys swarthy
hmsu: hums mush
acin: cain cian
ehirtw: whiter wither wreith writhe
defir: fired fried
abest: abest baste bates beast beats
adeemrst: dreamest mastered streamed
giinnps: pinings sniping
gnswy: gwyns ysgwn
deflou: dolefu fouled
acehrst: archest chaster tascher
afry: aryf fray
eprrssuu: pursuers usurpers
cdeilmop: compiled complied
abet: abet bate beat beta
acdefiiinot: deification edification
acdeins: candies incased
ist: ist sit
ahrsu: ashur surah
ceeeinorrst: recentiores reserection
bbginos: gibbons sobbing
aeeinntv: aventine venetian
aeilmns: malines menials seminal
aeimr: marie reima
aeemnr: amener meaner ramene
eerrvy: everry revery
brsu: rubs srub urbs
oor: oor oro
aehils: elisha hailes
eiqrsu: quires squire
aceiltt: lattice tactile
apst: past pats sapt spat stap taps
aeehrst: hearest theresa
cdehilr: childer redlich
aadin: aidan diana naiad
aceirrt: cartier erratic
aderrt: retard tarder tarred trader
elst: lest lets tels
deiort: editor rioted
ceeiprst: piercest receipts
eelsw: elwes lewes weles
eelrsv: levers revels
aaers: araes areas
ikls: kils silk skil
airt: airt tair tari tria
adeeiss: disease seaside
amno: amon maon moan mona oman
aaciir: aricia icaria
einprss: pressin snipers
ddeils: sidled slided
adegl: galed glade
apss: asps pass saps
amn: man nam
almtuu: mutual umlaut
eginnss: ensigns sensing
acorst: acrost actors castor castro croats toscar
acginrsv: carvings cravings
hnors: horns shorn
ggiinns: signing singing
elnow: enlow olwen
ghinoost: shooting soothing
iort: riot trio
adelr: adler alder arled
eglo: loge ogle
delnoprssu: splendours splendrous
cehort: hector rochet tocher
adeels: leased sealed
aegrt: grate great greta
ablmop: aplomb pombal
aenpsst: aptness passent
adeehknr: hankered harkened
agimnor: ingomar roaming
aeilnorst: orientals orleanist relations
inopst: piston points
bdeerttu: buttered rebutted
lstu: lust slut
aeenrtv: venerat veteran
eiorrs: rosier sorrie
adehs: hades heads shade
ddeiknr: drinked kindred
aeilnost: elations lateinos toenails
dgos: dogs gods
aaegintv: navigate negativa
aeiilnst: italiens litanies taliesin
adees: aedes eased
ginn: ginn ning
eghiilnrs: hirelings relishing
abiinrt: britain britian
acehlr: erlach rachel
eeinrstt: interest interets
eirv: iver rive
adeelnrtu: unaltered unrelated
aenv: evan nave vaen vane
ceeehls: chelsee leeches
aersttu: astuter stature
belstu: bluest bustle sublet subtle
deotu: doute oedut
cehins: chines inches niches
hlow: howl wohl
ceehirt: etheric heretic
aeirrst: tarries traires
ginsu: suing using
achi: chai chia
acgillnops: collapsing scalloping
iimnoprs: imprison promisin
eirs: ries rise seri sire
deeinpr: repined ripened
dir: dir rid
eglors: gorles legros solger
mnos: mons noms
anott: notta tanto
beemnorv: november novembre
aehm: ahem hame
dehop: ephod hoped
beeorsv: observe obverse
aeinrrt: terrain trainer
acelnt: cantle lancet
emnorsu: enormus nemours numeros
elmnu: lumen melun
emrstu: mestur muster sumter
enttvy: etvynt tventy
eehnorst: honester hortense
eoprrst: porters reports
adeilmt: matilde metilda
adenss: sandes sedans
aesx: axes saxe
doss: doss sods
ddeos: dodes dosed
ginnot: noting toning
notu: toun unto
efhls: flesh shelf
aelr: earl lare lear rael rale real
aeerrsst: asserter reassert terrasse
aaceinrst: ascertain cartesian sectarian
adinst: disant tandis
ills: ills sill
eest: etes sete tees
acefiiinorstv: verifications versification
addentu: daunted undated
cehlu: leuch uchel
duw: duw wud
dmoo: domo doom modo mood
acehrt: careth chatre thrace
aaeiilnortz: rationalize realization
adehmosu: housmade madhouse
ciix: cxii xcii
cixx: cxix xcix
adi: aid dia ida
imr: mir rim
anpss: snaps spans
llmy: llym myll
aegsty: gayest stagey
abgilnst: blasting stabling
nty: nyt ynt
ejsu: ejus jesu
alrtu: traul ultra
ghint: night thing
beinrtu: tribune turbine
abder: bared beard bread breda debra
acehs: aches chase sache
aails: ailsa alias
aersu: aures sauer
aehnopst: phaetons stanhope
deils: diesl sidle siled slide
cdeilo: coiled docile
aemsu: amuse mause musae
dennot: denton tendon
aemrt: artem maret mater tamer
aelm: amel lame leam mael male meal
aceinorst: creations reactions
adeinor: aneroid oradein
aailmrt: marital martial
deims: deism dimes
deloot: looted toledo toodle tooled
ainsv: savin vains
ehrt: erth hert ther thre
aentt: atten etant tante
afflo: offal olaff
eistx: exist exits
acegilr: glacier gracile
ghotu: ought tough
ceffor: coffer coffre
deipr: pride pried
ceeilnss: licenses silences
defu: edfu feud
ainn: anni nain nani
eghinst: hengist nighest singeth
adilu: aliud dulia
ceeprsst: respects scepters sceptres specters spectres
aachimnr: chairman charmian
aenry: reyna yearn
abeinooprrt: probationer reprobation
cdeors: cordes scored
aimr: amir mair mari
aaehmnopr: aphormaen phronaema
gnstu: stung tsung
ilxxx: lxxix lxxxi
eky: key kye
abelr: abler blare
abekr: baker brake break
aclnnoo: cloonan colonna
qu: qu uq
aalrst: altars astral
girs: gisr rigs
eeprtw: pewter repewt
elo: leo loe ole
epr: per rep
agnor: angor argon grano groan ongar organ ragno ragon
elrty: terly tyler
aghin: anigh haing hiang
ceinor: cornie enrico
deirs: desir dreis dries rides sired
eiprv: prive viper
alps: alps laps pals slap
aann: anan anna nana
aefmorst: foremast metafors
bdeir: beird bride
eflorsw: flowers flowres fowlers
adennorss: andersons sanderson
deeilrsv: delivers silvered
dstuy: dusty dutys study
eiklns: kensil likens silken
eforrsst: forrests forsters fortress
deinrw: rewind winder
hit: hit ith thi
est: est set ste
acginrt: carting tracing
ossu: sous suos suso
eehlmoss: holmeses homeless
enorrtuv: overturn turnover
ehnot: noeth theon
bder: bedr bred
inopr: proni ripon
dioprt: torpid tripod
beest: beest beets beset
ego: ego geo goe
dery: dyer ryde
aeknr: anker ranke
almpy: amply palmy
ailss: lissa sails salis silas
adgiimnrs: admirings disarming
rsstu: rusts truss
eforst: forest foster softer
deimnp: impend mendip
aefst: faste fates feast feats festa
defgiinnr: infringed refinding
adelpp: dapple lapped
acpr: carp crap parc
ceiklst: stickle tickles
emoors: morose resoom roomes
bnoruw: brunow woburn
eeilsx: exiles ilexes
aegirst: aigrets gaiters
cet: cet etc tec
beir: beri bier brei
ddeelu: delude eluded
cderu: crude cured
ehlot: helot hotel thole
adest: dates sated stead
eoqtu: quote toque
efhilss: hisself selfish
bennos: benson bonnes
eghinrrs: herrings sherring
dlot: dolt told
eeirv: ervei verei verie
illnu: nulli ullin
eeenprrst: presenter represent
eefrr: freer frere refer
aeeilrrtttu: litterateur litterature
hoos: shoo soho
aeemrst: steamer streame
acgir: agric cigar craig
adhins: danish handis
aelw: wael wale weal
adhinps: daphnis dishpan
ginru: ruing urgin
deegnr: gender gendre
ehsu: hsue hues
emop: mope opem poem
eelrs: elser reels serle
ahir: hair hari rhai
acerrt: carter crater
eipr: peri pier prie ripe
acisttu: atticus tacitus
acdit: dicat dicta
ceelrsu: recluse recules
aehinpt: paineth peithan
elnosss: lessons solness
enorry: eryron ornery
ailnv: anvil lavin vilna
eillpr: perill piller
aekt: kate take teak
eeorrtuvz: retrouvez trouverez
adestt: stated tasted
acinrstu: curtains nascitur
acehhstt: hatchets thatches
eenw: neew ween
eglos: gloes goles ogles
op: op po
deenrt: rented tender
adeghinr: adhering hardinge
aeeirstt: treaties treatise
egmnor: germon morgen
chu: chu uch
aeimnn: mannie meanin
aeinnpr: pannier pianner
adt: dat tad
ailt: ital lait tail
abeeillr: liberale reliable
bestu: beust tubes
ppu: pup upp
ginr: grin ring
betu: bute tube
aelprsy: parsley players sparely
deortu: detour douter routed toured
beeemprst: september septembre
ailps: lapis pails
adeemn: demean meaned medean
elrstu: luster lustre result rustle sutler ulster
dillwy: diwyll wildly
aenpst: pantes pentas pesant
agry: gary gray
aeerw: aweer waere
aekps: peaks spake speak
esz: sez sze
apt: apt pat tap
acmor: coram marco
acegilrs: glaciers scaliger
abens: banes beans
hosst: hosts shots
enottu: tenuto teuton
addeor: adored deodar
aagimnnost: antagonism montagnais
cost: cost cots scot
enos: eons noes nose ones seon
dno: don nod ond
aint: aint anti tain
ikl: ilk lik
chiu: chiu huic
adehrst: hardest threads
denot: noted toned
beimrs: bersim simber
deilry: elidyr ridley
aaegtwy: gateway getaway
adginrw: drawing warding
aiimnrst: martinis ministra
aahll: allah halla
acemnu: acumen menauc
ceipss: pisces spices
anp: nap pan
eeprstx: experts exprest
ceeilns: license silence
einopt: petion pointe
bins: bins isbn nibs
isssy: sissy sysis
adehms: mashed shamed
dgiinty: dignity tidying
cdeenors: censored seconder
acehint: chiante teachin
ceilppr: clipper cripple
ehnrtu: hunter nuther
los: los sol
efilr: flier rifle
deinsw: widens windes
awy: way yaw
dios: dios dois
imnost: inmost mintos timson
ceeinnss: incenses niceness
aelmps: lampes maples sample
gipr: grip prig
ast: ast ats sat sta tas
orsu: ours sour
adeglnr: gnarled legrand
allosww: swallow wallows
eiln: lien line neil niel nile
aknt: kant tank
aalls: allas salla
abeqsu: absque basque
aelrsst: artless salters
deeimrst: demerits mistered
aessty: sayest yeasts
adeeenrs: endeares serenade
aerw: ware wear
aaimns: animas samian
denorw: wonder worden
eiinrsst: insister sinister
eiprs: peris piers pries spire
dnosy: dyson synod
aemns: manes manse means names
deginnoprt: portending protending
cceilrs: circles clerics
acdens: ascend dances
elrsy: lyres slyer
bdestu: busted debuts
amnu: anum manu maun numa uman
frsu: furs surf
abdenors: broadens rosenbad
defnoru: founder neudorf refound
aeinst: sainte tenais
achks: hacks shack
ainopss: passion spinosa
eimnt: meint menit
ceimr: crime merci
pry: pry pyr
hrstu: hurst hurts
addeemnru: maundered undreamed
elops: poles slope
hist: hist hits sith
losw: lows owls slow sowl
amos: amos maso
ahlsw: shawl walsh
amst: mast mats
einosuv: envious neovius veinous
nooprt: porton pronto
aceinnsst: incessant instances
cdeemmnor: commender recommend
egiln: elgin ingle ligne linge negli nigel
delno: eldon olden
adelor: ordeal reload
cdeers: creeds decres screed
eorsst: sorest stores
defhiins: fiendish finished
adeiln: aldine daniel delian denial nailed
ahkt: kath khat
abelnu: nebula unable
aceilprt: particle prelatic
deorv: dover drove roved
adins: dinas disna
ddeilrs: didlers riddles
dinor: ordin rodin
aeenrt: eterna neater
dgilnor: dorling lording
eosw: owes woes
emno: omen omne
aeeeprrt: repartee repeater
abeill: belial liable
acghimnr: charming marching
eekrsst: sekrets streeks
adnowy: adonwy adowyn
nostu: snout touns
ddeinw: weddin winded
eorrtt: retort rotter torret
emnno: monne nomen
eeinnnt: enneint tennine
gilnoss: goslins losings
aceprs: capers casper scrape
eiklrt: kilter kirtle
cehlos: elchos loches
beorsw: bowers bowres browse
ddgw: ddwg gwdd
ademno: daemon moaned modena
deirv: deivr diver drive verdi
ador: dora road roda
aty: tay yat
ces: ces sec
er: er re
aot: oat tao
einorssu: neurosis resinous
delsw: dwels welds
cehist: ethics itches
deprsu: perdus prudes pursed
acry: cary racy
efinsst: fitness infests
efghirt: fighter freight
aill: alli illa llai
cvx: cxv xcv
adeisv: advise davies
ellt: llet tell
deefgiirs: seigfried siegfried
aaenp: paean paena
epsw: pews spew swep
dlloy: dolly lloyd
agilnst: lasting salting
acnorr: carron rancor
dddeew: edwedd wedded
adens: andes danes deans sedan
efilort: loftier trefoil
agnosw: gowans wagons
aemrtt: matter mettra
adilp: palid plaid
defgor: forged grodef
adenrs: ardens snared
aenot: atone eaton notae oaten teano
aiprs: pairs paris rapis spira
mor: mor rom
egiilnrsv: revilings silvering
aaghlmn: laghman langham
cdeeirst: discreet discrete
adglnoo: dongola gondola
eeirstv: restive veriest
cdhltuvw: dutvwlch tudvwlch
dnu: dun und
orttu: trout tutor
acmsu: camus sumac
aeinrrst: restrain strainer trainers
bors: orbs robs
fr: fr rf
eehns: esneh sehen sheen
agls: gals glas lags
aertv: avert vater
elssty: slyest styles
aeginrst: stearing tangiers
orstu: ortus roust routs stour tours
adgginru: guarding guignard
ceehk: cheek cheke
einnrs: inners sinner
aenoprt: operant protean
beirs: bersi biers
denorsu: resound sounder
eimprs: mepris permis simper
rtu: rut tru tur
aeiprss: aspires praises serapis
anoprt: parton patron
einrv: ervin niver revin riven venir viner vrein
anuy: auny yuan
eemprs: semper sempre
deesw: sewed swede weeds
aeelpp: appele peapel
aeell: aelle allee
aemrrtu: erratum maturer
eefr: fere free reef
eintu: tenui unite untie
ops: ops sop
aenptt: patent patten
ahls: hals lash shal
einrtt: trient trinet
adeprw: pedwar warped
acdehinops: deaconship discaphone
aginnrt: grannit ranting
ort: ort rot tor tro
iprsu: prius sirup
oostt: sotto toots tosto
belsu: belus blues
acprsu: cupars parcus
behilprsu: publisher republish
aacellp: capella laplace pallace
egnst: gents tseng
defgit: fidget gifted
hilst: hilts thlis
ooprsu: porous pursoo
ehost: hoste theos those
aht: hat tha
deemrstu: demurest mustered
deou: oude oued
ainop: piano piona
aeinpst: patiens sapient
adeiinoprtt: partitioned trepidation
eeelprss: peerless sleepers
ceoprstt: prescott protects
acipr: capri picra
beeil: belie liebe
acegiilost: egoistical egotisical
acgrs: crags scrag
alw: awl law
chin: chin inch
aadenr: andrae andrea darena
efilst: itself stifle
cdeinorstu: discounter introduces reductions
bceimno: becomin combien combine
eiv: vei vie
addeeknr: darkened deranked
eeirrrt: retirer terrier
aben: aben bane bean
aelmp: ample maple
emoor: moore romeo roome
cdinostu: conduits discount
opt: pot top
acennorstv: conservant conversant
altw: walt wlat
adei: aide iade idea
eloss: loses losse sloes soles
fgi: fig gif
dim: dim mid
cdeiorrst: creditors directors
aeirv: ervai vraie
acelpr: parcel placer
cry: cry cyr
adeprsssu: pardessus surpassed
eelprs: lepers repels
eimn: emin enim mein meni mien mine nemi
aelry: early layer leary leray relay
ddey: dyed eddy
biort: orbit ribot
aeeginr: agreein erigena
cdeiins: incised indices
adehn: hande hedna
aalm: alma mala
aegimnrs: germains smearing
dent: dent tend
abgikns: bakings basking
ehins: hines hisen shine
degin: deign digne
aelnortt: tarleton tolerant
aehlrt: halter lather
eiknrtt: knitter trinket
eorw: ower owre rowe wore
eghnny: genhyn gynhen
abess: bases basse
cehhilrsstu: chiselhurst chislehurst
degiint: editing ignited
agntw: gnawt gwant twang
aaadegntv: advantage davantage
aeinnot: antoine etonian
aelsw: wales weals
egintw: gwenit twinge
aegns: agens agnes asgen
aeginr: ainger gainer regain
cehinps: pinches schepin
ehoopr: hooper orpheo
acesu: cause sauce
aelntt: latent talent
emost: moste motes smote tomes
aen: aen ane nae nea
imst: mist mits smit
adelnr: erland ladner larned
ags: gas sag
dem: dem med
achn: chan nach
aesstt: states tastes
enoprs: person sperno
aadehmmmno: mahommedan mohammedan
aehhst: heaths sheath
acdeenrt: cantered decanter nectared recanted
eefhirs: freshie heifers
eilpry: ripely ripley
aenoprtt: portante poterant
ceeilnrs: reclines silencer
ow: ow wo
deimmsu: dummies mediums
acinst: antics sancti sciant
adforrw: forward froward
aenuy: yeuan yuean
eefhrrs: fresher refresh
abd: bad dab
celrsu: clerus cruels ulcers
abcelmrs: clambers scramble
mopr: porm prom romp
depsu: dupes spued
adelm: lamed medal
acenos: canoes oceans
hoot: hoot otho
ceeiprs: pierces precise recipes
aimmnor: marmion miramon
beemmrs: members membres
ehnorst: hornets shorten thrones
aeginrt: geraint granite ingrate tangier tearing
eills: ellis lisle
hnsu: huns shun
aeeilnntv: levantine valentine
wy: wy yw
cehimor: homeric mechior
bein: bein beni bien
benort: breton bronte
acdehipsst: cadetships dispatches
noost: ontos stono
denost: ostend stoned
cdenotu: coudent counted
ilvx: lxiv lxvi xliv xlvi
adnw: dawn nawd wand
aceelrt: electra treacle
adeiprs: aspired despair praised
aenrs: earns nares nears ranes saner seran snare
desw: dews weds
eoprss: posers presso
derstu: duster rudest rusted
iilx: lxii xlii
ertwy: erwyt weryt
acks: acks cask sack
aelpsst: pastels staples
abeilrt: alberti etablir
hrtw: thwr wrth
aeirs: aries arise raise serai
eisstu: eustis suites tissue
demos: domes modes
aenpstt: pantest patents pattens
ip: ip pi
ehinsw: whines wishen
abenry: barney bernay nearby
eekns: knees skene
eiilllm: melilli milelli
adlltu: alltud lladut
acrs: arcs cars cras scar
aeorstt: rosetta toaster
aennorst: anertons resonant
adehioprt: aphrodite atrophied
cenos: cones nosce scone
adelnoor: leonardo loredano
egorsu: grouse rogues
aceginrt: catering creating reacting
aeklns: ankles kensal
acefs: cafes faces
eeins: eines seein seine
ddeeinnt: indented intended
eeeinprrsst: enterprises intersperse
egilnpry: preiglyn replying
cino: cnoi coin icon
eesttx: etexts sextet
eeiprst: prieste respite speerit
abc: abc bac cab
aegillp: pigalle pillage
degiklo: doglike godlike
adglw: glawd gwlad
lmpsu: lumps plums slump
cenot: cento conte
aaceeinn: encaenia nicaenae
abinost: bastion boastin obtains
acr: arc car rac
ilv: liv lvi vil
eelpss: pleses sleeps
aeehrstt: theaters theatres
adeillrv: darville rivalled
aghirs: garish grisha
deir: dire drei reid ride
eimnos: monies simeon
egoru: goreu rogue rouge
acdeerrt: retraced terraced
ceenrss: censers screens
eellv: level velle
adimnos: domains madison
eimqtuu: equitum quietum
eikr: erik keir
ciprsy: crispy cypris
dinsu: dinus indus
deilnssw: wildness windless
eiknrt: reknit tinker
giilnp: gilpin piling
acelr: claer clare clear ercal lerac
deefiis: deifies edifies
agir: agir gair riga
addei: addie aided
inoopt: option potion
achilrst: chitrals christal
alott: lotta total
efint: feint fient
deeekp: keeped peeked
ahms: hams mash sham
dehnorsu: enshroud unhorsed
girt: girt grit
aailn: alani liana
beor: boer bore ober orbe robe
ghins: hsing singh
cersu: cures curse
acen: ance caen cane
aegginor: georgian georgina
cddeesu: deduces seduced
acehrtt: chatter ratchet traceth
boost: boost boots
aegmntu: augment meugant
ehorss: horses shores
deintu: united untied
cehops: cheops epochs
abn: anb ban nab
addelrw: arddelw drawled
aegmnr: german manger mangre margen
aerstw: rawest waster waters
deersv: served verdes versed vesdre
ademnors: ransomed resamond
ehirst: riseth theirs thiers
foru: four fuor
acders: cedars sacred scared
aglor: lagro largo
aeegnrst: estrange grantees reagents sergeant
eefiln: feelin feline
eijnru: injure jurien
mt: mt tm
deilops: despoil spoiled
foor: froo roof
alssv: slavs vlass
agint: giant tangi
estt: sett test
adelsy: delays ladyes
aeeglls: alleges gallees
hotu: hout thou
iss: iss sis
biu: bui ubi
iklns: kilns links slink
eenqu: neque queen
cdeoprru: procured producer
aelnsy: sanely slaney
eksy: keys skye
aamnnu: mannau maunna
adeegiinorrtt: deteriorating redintegratio
enorw: owner rowen worne
deiprs: prides spider spired
ainorstu: notarius souriant
aacdrwy: cadyawr caradwy
ilps: lips lisp slip
aeeghinrrs: rehearings rehearsing
efil: feil file flie leif lief life
aamss: amass massa
bilos: blois boils
deinrrstu: intruders unstirred
dehirtv: driveth thrived
aden: daen dane dean edna nade
aeinnrsty: tyrannies tyrannise
adeimns: damiens maidens
abdehor: abhored deborah
eikmoss: eskimos smokies
deglno: golden longed
ehist: hites seith
einqtu: nequit quinte
deiosstu: outsides studiose
eghin: hinge neigh
aekmrst: markest markets
beelmrrsu: lumberers slumberer
ceginnnott: contenting contingent
alsw: awls laws sawl
aceorst: certosa coaster soracte
anw: naw wan
elmsy: melys mysel
aprsst: sprats straps
agmnort: gormant morgant
aeelrr: larree realer
aderstw: drawest setward steward
cesst: ctsse sects
ceort: certo corte
adeinrv: invader viendra
dehoop: hooped poohed
beffru: buffer rebuff
degiinrs: desiring disgrein residing
giln: glin ling
aceinrst: canister certains cestrian scantier
eirsttu: tertius truites
benry: byner byrne erbyn
aeglno: angelo lagone
aeilnp: alpine plaine
adeeimstt: estimated meditates
agimns: gamins magnis
deiprstu: disputer stupider
aenosss: saesson seasons
deim: diem dime idem
deilsu: dulsie edulis
nnoo: nono noon
cdeeeiprt: decrepite receipted
cdehin: inched niched
aceeeinrsss: necessaires necessaries
eeenrrs: serener sneerer
adry: dray yard
abno: bona oban
aiprt: pairt parti
acint: actin antic canit
imno: inom omni
ehoss: shoes shose
defmors: deforms serfdom
ainrst: sartin starin strain trains
aaaimnrst: samaritan sarmatian
achst: chats scath
eis: eis sei sie
aimns: anims mains
dees: dees seed
demnos: demons mondes
acehir: archie chaire
been: bene eben
deeelpprx: perplexed preplexed
dikss: disks skids
aestt: satte state taste teats testa
adst: dast stad
erssu: ruses russe users
ehiknrt: rethink thinker
ehortt: hotter tother
deeirssv: dissever diverses
denwy: enwyd wyned
aellsy: alleys salley
einpss: snipes spines
eiiimnorst: ministerio minorities
dllory: drolly lordly
acenrst: canters recants trances
aegrs: esgar rages sager
ceeprst: respect scepter sceptre spectre
dgoo: godo good
deillnsy: lindleys lindsley
adegiln: dealing leading liagden
eelopp: peopel people
einns: ennis innes nines
ainsty: sanity satiny stayin
adnr: darn rand
ghhit: hight thigh
aeegilp: pelagei pelagie
ab: ab ba
epw: pew wep
aceelnru: cerulean laurence
ceops: copes copse scope
eirrsv: rivers servir
degilnu: eluding indulge
adefint: defiant fainted
oott: otto toot toto
aery: ayer year
osu: sou suo
eefst: feste fetes
cenorstu: construe counters recounts
alnu: luan luna
ehlosv: hovels shovel
acdemp: camped decamp
dellnoru: roundell unrolled
eilmot: melito moleit
cnoostt: cottons scotton
cddeeir: decider decried
eegilnr: leering reeling
deeenprt: preetend repented
aept: pate peat tape
egiimnprs: premising simpering
aehorst: asthore earshot
eeilnrst: leinster listener
aacmnot: mantaco matonac
eefls: feels flees selfe
cdior: doric rodic
horstt: thorts troths
ceeptx: except expect
ekops: pokes spoke
aeinpr: napier rapine
agin: agin gain gian gina
deop: dope oped
acdenrt: credant tancred tranced
enst: nest nets sent tens
eehiss: hessie hiesse
ceeimnoos: economies economise
addeinr: drained dreadin
degino: doeing gideon
agnrst: grants strang
eeil: elei elie
dorwy: dowry orwyd rowdy wordy
adders: adders dreads sadder
aabln: alban banal laban nabal
efmorr: former reform
bdemoor: bedroom boredom
ceov: cove voce
fino: foin info nifo
aegir: aergi garei geira
bnu: bun nub
bceru: bruce bucer
eeirvv: revive vivere
ackss: casks sacks
denoprs: ponders reponds respond
aeeiirstv: varieties vestiaire
eghosttu: oughtest toughest
adeinst: andiest detains instead sainted stained
ceoprrrsu: precursor procurers
anno: anno anon
elmot: molet molte telmo
belmrtu: trumble tumbler
aalnrtu: arnault natural
acer: acre caer care race
adeirs: aiders idears raised sidera
eilnst: enlist inlets listen silent tinsel
elosv: loves solve
aarrtty: rattray tartary
aeilr: elira leira
aeinnr: earnin nairne nearin rannei
acdeiimno: dominicae nicomedia
