eilpprs: ripples slipper
aberst: barest breast
addert: darted traded
aggnow: gognaw waggon
aginrt: gratin rating
hors: hors rhos
abeinort: baritone baronite
agikmns: makings masking
nnosu: nonus nouns
ceehlry: cheerly lechery
aehmn: hanem heman
eflntu: fluent netful unfelt
acdeprs: scarped scraped
eiopstt: potties tiptoes
lmoos: looms mools
eew: ewe wee
acnsstu: sanctus tuscans
inps: nips pins snip spin
gilnru: luring ruling
ceeginptx: excepting expecting
aceilnopstu: peculations speculation
eorsttu: stouter touters
aeg: age gae
iorv: ovri rivo viro voir
eeglnst: gentels gentles
ors: ros sor
aehrrss: rashers sharers
bello: bello obell
aegnrrs: garners rangers
aaeistt: aetatis satiate
ddeenrs: dresden reddens
addeenrrtu: underrated unretarded
epstu: peust setup tepus upset
aaeiprt: patriae tarpeia
orrst: storr torrs
cikps: picks spick
cdeinw: wendic winced
aemqrsu: marques masquer
adddels: daddles saddled
bertu: brute rebut
ceilmop: compile polemic
einprrst: printers reprints
eouv: voeu voue
acemrs: carmes creams scream
adeimnost: dominates maidstone
aceilmnsu: calumnies masculine
adehprs: phrased shepard
detu: deut duet
eginns: ensign ingens
ahkrs: harks shark
belmrstu: stumbler tumblers
aeksst: askest skates stakes steaks
cddeeirt: credited directed
aclpss: clasps scalps
aehkr: harek heark
nov: nov ovn von
eeortuv: ouverte trouvee
imnor: minor morin
amntuu: anutum autumn
acghikln: chalking hackling
cehorst: rochets torches
enopst: posent posnet sponte
aegrsv: gervas graves
ilst: list silt slit stil
cosst: costs scots
aeim: aime amie meia
aachrtw: cawthra trahawc
aaceilrv: calvaire cavalier
agillnsy: sallying signally
egilnr: erling linger
aeghinv: haveing heaving
aeiprs: aspire persia praise reipsa
abeerrtt: barrette berretta
erstw: strew wrest
aciinprs: crispina priscian
depry: pryde pryed
eimorstu: moisture moustier
deenry: edeyrn yerden
aeinprrst: terrapins transpire
elow: lowe owle
ipt: pit tip
rt: rt tr
ceorrsu: courser recours
acostt: ascott tacots
ackst: stack tacks
denst: dents tends
eiimnr: meinir merini
acehinr: reachin reinach
cemor: comer crome
aceehpr: cheaper phearce
loo: loo olo
adrw: draw ward
aertu: autre terau tuera
eoprrtt: perrott treport
aeegprss: asperges presages
beerstw: bestrew webster
enops: opens posen
deehirtw: weithred withered
abilny: libyan lybian
degil: degli glide
cprsuy: cyprus sprucy
deilrsw: swirled wilders
eilstu: lieuts lustie
adelps: lapsed pedals pleads
abenrt: banter barnet brenta
els: les sel
aimnrt: antrim martin
norst: snort stron
aehlwy: haelwy whaley
adginrt: darting trading
eeisv: eveis sieve
einoprt: pointer protein
aent: anet ante etna neat taen
beeilrt: berliet liberte
aeimnrsu: measurin sumerian
ceirt: ecrit trice
adef: adef deaf fade
aceghint: cheating teaching
eops: esop opes poes pose
aors: aros oars rosa soar sora
nrsu: runs urns
adim: amid dami maid
aeginnost: negations saintonge
deilv: devil divel lived vleid
aep: ape pea
aders: dares dears reads
aaeehhimprtt: amphitheater amphitheatre
ginotw: towing wigton
cekps: pecks speck
adel: adel dale deal dela lade lead
ckmos: mocks smock
beintt: bettin bitnet bitten
enrtu: tuner turne
afstu: fatus faust
aeeimnnorstu: enumerations mountaineers
ipst: pits spit stip tips
acder: ardec cader cared cedar raced
eelrtt: letter lettre
aimpr: pamir parmi prima
adenpt: panted pedant pentad
aeehhrt: heareth heather
ehoprst: porthes pothers strophe
eiqttu: quiett quitte
ehllo: hello holle
iimnprst: imprints misprint
aelmprt: templar trample
hrty: rhyt yrth
afl: alf fal
degilmnoru: mouldering remoulding
emnory: meryon moryen romney
eeiinoprtt: petitioner repetition
demo: dome edom mode
ilpst: spilt split
aeksw: askew wakes
eoqstu: questo quotes
adeilr: lerida railed
hirw: rhiw whir
ahss: hass sash
aadglnr: garland ragland
ikn: ink kin
enost: notes onset seton steno stone tones
fhirt: firth frith
ehstty: tethys tythes
diot: doit tido
cii: cii ici
hmsty: myths smyth
aerrt: arter terra
efinst: feints finest infest
eim: ime mei
ain: ain ian ina
aest: ates east eats esta sate seat stea taes teas
eeerrssv: reserves reverses
iloss: soils solis
eeiln: elein leein lenie
jnotu: junot junto
loop: loop polo pool
adehoort: dorothea theodora
aehtw: waeth wheat
eghhit: eighth height
ael: ale lea
dinvy: dyvin vydin
aadeirt: atridae radiate
eillnsty: silently tinselly
celrtuy: cruelty cutlery
abertt: batter tarbet
fintu: fiunt unfit
aainrstu: austrian saturnia
cdery: cyder decry dycer
aaegt: agate gaeta
adentv: advent devant vanted
aceginrs: creasing grecians
acckoss: cassock cossack
cdehosu: choused douches
aeirrs: raiser sierra
aaeeknrw: awakener reawaken
aalr: alar lara
bdelruy: bludyer ledbury
eeenrrt: enterre reenter terrene
aelnprt: planter platner replant
aceqsu: casque sacque
aacehrtt: attacher catraeth
gno: gon nog
aceelr: cereal cleare
eikps: pikes spike
aelmprst: templars tramples
chnot: nocht notch
egmno: gnome monge
acdelr: calder cradle
eimnort: meriton montier
eekls: keels leeks sleek
eios: oise osei
eimns: mines nimes
aehnps: phanes shapen
aadd: adad adda
aginsty: staying stygian
dens: dens ends send
ginorst: sorting storing
aeknss: snakes sneaks
gilnoot: looting tooling
adelmr: delmar medlar
derty: teryd tryed
abcehr: breach chebar
ahst: hast hats
aefss: fasse safes
addels: laddes saddle
agimnt: mating taming
ens: ens sen
alsst: lasts salts slats
cdeit: cited dicte edict
aadmn: amand daman manda
fisst: fists sifts
aaenr: arena neara
aeennprtt: penetrant repentant
deopst: depots despot posted
eeimprsss: impresses premisses
cdeeeirv: deceiver received
aersw: resaw sware swear wares wears
delmos: models seldom
beirt: biter tiber tribe
adehks: kadesh shaked
desu: deus dues sued used
eehmoorsvw: howsomever whomsoever
eers: eres erse rees seer sere
acilu: aulic lucia
dggiinr: girding griding
aeilprst: pilaster plaister
ceirs: cries crise
moors: moors rooms smoor
ceerst: certes erects secret
eeiirrv: riveire riviere
defgiiins: dignifies signified
adelpps: dapples slapped
deeehlw: wheedle wheeled
ilnsu: linus nilus
acmru: carum curam
aelmopr: palermo pleroma
eefnru: neufre unfree
eeilprst: peltries reptiles
innosu: unions unison
adhry: hardy hydra
aeor: aero oare
aaelnrt: lateran nateral
dru: dru dur rud
aeginnortv: renovating venorating
aglnos: logans slogan
aefl: flea leaf
akr: ark kar
bdir: bird brid
aceehmrs: cashmere charmees marchese
agl: gal lag
cdeeenrt: cederent centered
imost: moist omits
aeoprst: esparto portsea seaport
ailn: lain nail
ehnors: herons senhor
adefly: fadely flayed
ils: ils lis
acdelw: cadlew clawed
ahstw: swath thaws washt whats
aeehrstw: sweareth weathers wreathes
deenrv: denver nerved vender
mno: mon nom
aegrz: gazer graze
deity: deity tidey
aeegimnprt: impregnate permeating
eilsw: lewis wiles
acdeknr: cankred cranked
deeorrst: resorted restored
aceinnst: ancients instance
cdemu: ducem emduc
ahy: hay yah
ceerssu: rescues secures
cdeginnos: consigned seconding
ahs: ash sah
enrrstu: returns turners
ainrstt: startin transit tristan
ikln: kiln link
anprstuu: prunatus pursuant
allw: llaw wall
aacdehln: chalaned chaldean
ails: ails lais lisa sail
eimnv: nivem venim
achrst: charts starch
ess: ess ses
bceoort: october octobre
cdeortu: courted docteur
aabeillpp: appliable palpabile
egor: ergo geor gore ogre roge
hpu: hup puh
enrsu: nurse runes
acdorw: cawdor coward
aemnor: maenor romane
aeelrt: latere relate
eitv: veit vite
acdertu: decatur traduce
pssu: puss sups
almor: molar moral
aeegnv: avenge geneva
bos: bos sob
dlor: lord rold
afirs: fairs faris
abdeginr: bearding breading
ddego: dodge doged godde
instu: nuits tunis units
aeginst: agentis seating teasing
ceoors: coorse roscoe
egilors: gloires glories
aeeiilrst: israelite realities
aegirsv: argives gervais gravies
abehlms: belsham shamble
cefhs: chefs fesch
ccenoort: concerto concreto
acerss: caress csesar scares scarse
drwy: drwy rwyd wydr wyrd
acghins: achings cashing chasing
amr: arm mar ram
adesv: saved vedas
ell: ell lle
deeilv: deevil levied veiled
adlu: auld dual laud
acerrv: carver racvre
ginss: signs sings
eegiknps: keepings spekeing
aaclrvy: calvary cavalry
aanrtt: rattan tartan
deefgin: feeding feigned
din: din ind nid
aeilmsttu: mutilates stimulate
ehrsttu: rusteth shutter
befir: brief fiber fibre
deginnoprs: ponderings responding
eeelsv: eleves levees sleeve
eeflrs: erself feelsr
eekp: keep kepe peek
eo: eo oe
egnoorrsv: governors grosvenor
ahor: hoar hora
agnw: gnaw gwan wang
elmnos: lemons melons solemn
deesu: deuse suede
acemnors: camerons romances
deistu: duties suited
aceiinorstt: reactionist recitations
adlmy: madly ymlad
adgiilt: digital idiglat
eknow: knowe woken
cinnotu: countin unction
acehp: chape cheap peach
hntu: hunt thun
ehilos: helios holies
hills: hills shill
deos: dose odes
clos: clos cols
aehlz: hazel hazle
beirst: bestir bistre tribes
aceginpr: capering pencraig
eginrstw: strewing wresting
dors: dros rods
dehit: deith dieth edith
deely: leedy yeeld
cinrstu: custrin incrust scrutin
hortw: rowth throw worth wroth
egirt: greit tiger
rwy: wry wyr
aglot: aglot gloat
deeepr: deeper peered
degloss: dogless glossed godless
eirss: rises sires
iopsst: posits possit
aprs: pars raps rasp spar
acnot: acton canot canto
eeenrv: veneer venere
ceors: cores corse croes score
aegnrt: argent garnet garten gretna
deit: diet dite edit tide tied
demtu: medut muted
aairs: arias saari sarai
deefil: defile fidele
efilrs: fliers rifles
aceeeilmnpst: mantelpieces specialement
belmru: lumber rumble umbler
cdeinrs: cinders discern rescind
ddeeirs: desired resided
aefsst: feasts safest
giinrt: riting tiring
eenprst: present repents serpent
acelst: castel castle cleats
emor: more orme rome
ahors: horas shoar
diorr: orrid rodri
eelprt: pelter petrel
deinw: edwin widen winde
acdeilms: decimals declaims
aimss: amiss missa
acss: cass sacs
aeemprtt: attemper temperat
aeinstv: avintes naivest natives
hostu: shout south
ademr: armed dream madre
aclsu: claus lucas
almny: lyman manly
eklosy: kyloes yokels
doprs: drops prods
adegln: angled dangle
abcdeeelrt: braceleted celebrated
adoty: toady today
ehns: hens shen
diw: diw wid
belsy: selby sybel
aginpprst: strapping trappings
aeilm: amiel email
gstu: gust guts tugs
beilr: brile liber libre
cehiknst: kitchens thickens
ceorsu: course crusoe oscure scoure source
aekl: ekal kale lake leak
beghinrt: brighten bringeth
bhort: borth broth throb
emmrru: murmer rummer
aeeghinrt: reheating rheingate
ijsstu: jussit justis
ceens: cense scene sence
adeeprv: deprave pervade
aeenntt: annette teneant
emo: meo moe ome
ivx: vix xiv xvi
aemrst: master stream
eprrsuu: pursuer usurper
achmor: morach morcha
degilnostu: longitudes ungodliest
ginrty: trying tyngir tyring
aeglm: gamle gleam
ooprt: porto proto troop
abdelor: laborde labored
aesst: asset seats
eels: eels esel lees
aeinpt: patine petain
ceilnos: conseil inclose
aeimnrs: marines remains sirname
beins: biens ibsen
adeis: aides aside daies ideas sadie
eefrst: fester freest
abelst: ablest stable tables
aaprt: apart prata
kloo: kloo look
eit: ite tie
coops: coops scoop
bdu: bud dub
achnstu: chaunts staunch
depu: dupe pued
dhorsu: rhodus shroud
addeln: dandle deland landed
aacers: caesar sacrae
aesstw: sawest sweats wastes
aehprs: phrase seraph sharpe
inpss: snips spins
celnossu: consules counsels
acnnor: cornan cranon
acelmt: calmet camlet
adess: assed essad
adhny: handy haydn
eimrt: merit miter mitre remit timer
adeisswy: sideways waysides
aceln: ancle clane clean lance
ceeinprst: prentices prescient
denorsv: vendors vonders
adelst: lasted leadst salted slated
ahikrs: kishar rakish
deimmr: dimmer rimmed
ipss: piss sips
egnt: gent teng
acegors: cargoes corsage
hrsttu: thrust truths
ilntu: unlit until
efirst: sifter strife
ceru: creu cure ecru recu
aeprt: apter parte pater petra prate taper
ader: arde daer dare eard read
aelmor: maelor morale
ersstu: russet surest tusser
osy: osy soy
ehlorsy: horsely horsley
eru: eur rue ure
eno: eno noe one
efginr: finger fringe
deippr: dipper ripped
cior: cori rico
otw: owt tow two wot
flosw: flows fowls
gnnuy: gunny gynnu
adeers: erased seared
dehors: dehors hordes horsed rhodes shored
amnoor: maroon romano
deelovv: devolve evolved
eimr: mire remi rime
kou: kou kuo ouk
belno: nobel noble
inor: iron noir
eeinrtty: entirety eternity
adeorr: adorer ardore roared
efillr: filler refill
deiistt: ditties tidiest
abelstt: battles tablets
acst: acts cast cats
anpst: pants snapt
aeenoprst: esperanto personate
eilr: lire riel rile
aeglmy: gemaly gleamy
acdeorstu: croustade educators
ehinrss: shiners shrines
aeemrsst: steamers streames
aemnory: anymore maroney
tv: tv vt
aeginp: apeing piegan
giinnns: innings sinning
acceino: cocaine oceanic
ent: ent net ten
aderrw: drawer reward warder warred
ostw: stow tows twos
ailv: vail vial
acehsstt: chastest satchets
beglot: gelobt goblet
ailnpt: plaint pliant
eegrrsu: guerres resurge
aceprt: carpet parcet
ft: ft tf
adfru: dafur fraud
eenr: neer nere rene
eeilprsty: peristyle priestley
deinr: diner nidre
acinr: cairn racin
adehm: adhem ahmed
einrt: inert inter tenir trine
elv: lev vel
aakt: kata taka
copr: corp crop proc
acerv: carve crave
aistw: waist waits
aerr: rare rear
aeinr: einar reina
adefs: deafs fades
adors: adors roads
eeilw: weile welei
inpt: nipt pint
abeiinrs: bairnies iberians siberian
adikn: dinka kinda
chkos: hocks shock
deggor: dogger gorged
aeprstu: pasteur pasture
aelttv: tavlet vattel
hnstu: hunts shunt
oprst: ports sport
cx: cx xc
agrssu: sargus sugars
ainnost: anoints nations
ensy: enys esny syne
deflor: elford folder
ahkns: khans shank
ceirstu: certius icterus
acenrv: carven cavern craven
addeeiprs: despaired disapered
amnnor: nanmor norman
aehpss: phases shapes
aeimrr: marier marrie
aabdeil: badelai labadie
deipsu: depuis upside
ahprs: harps sarph sharp
achs: achs cash chas
aaghr: agrah hagar
eginrr: erring ringer
definr: finder friend
cegiiln: ceiling glicine
eginst: signet tinges
coprs: corps crops
dmnuy: mudyn mundy
dnos: dons nods
eghils: leighs sleigh
ddgoru: godrud gudrod
deeginrs: designer resigned
dgntwyy: gwydynt gwyndyt
dey: dey dye
aagmm: gamma magma
iiilx: lxiii xliii
amnos: mason moans
acemr: cream mcrae
beruy: buyer ebury
ehnor: heron horne rhone
hmoo: homo hoom
irt: tir tri
ey: ey ye
deggir: digger rigged
enno: none onne
aprt: part rapt trap
ilms: mils slim
beeglnor: blorenge grenoble
ddeeir: deride reddie
aaeprt: pataer patera
deefno: eofned fondee
cdeoo: cooed dooce
aehmt: maeth meath
aceins: casein incase
hinst: hints thins
acginrv: carving craving
acesw: cawse sawce
adeempst: stampede stepdame
aceeeilmnpt: mantelpiece mantlepiece
ahirrs: harris sirrah
deiimnoss: demission simonides
aelns: lanes leans
aehllr: haller hellar
acdimno: mandioc nomadic
agnr: gran rang
abegt: begat gabet
ahlot: altho athol loath
aerstt: strate tetras treats
aenrstu: natures saturne saunter
aghinprs: harpings phrasing
eery: eyre yeer yere
ceinqu: cinque quince
aaeginw: gawaine nawagei
ems: ems mes sem
aenstu: austen unseat
ddeeimnnru: undermined unreminded
ailmpsst: palmists psalmist
abu: abu uab
aehlorw: harlowe oehrwal
abelm: amble blame mabel melba
bdeilru: builder rebuild
aeps: apes apse peas spae
acehmr: charme marche
eflu: flue fuel
beilrst: blister bristle
acelrst: cartels scarlet
ehsw: hews shew
adeeelrs: released resealed
orty: tory troy tyro
adehil: dalhei hailed
acehmrr: charmer marcher
beeelt: beetle teeble
eeiqrsu: esquire queries
adeeinrstt: reinstated straitened
aabcdkrsw: backwards drawbacks
bnrtu: brunt burnt
aginry: grainy raying
aeglru: regual regula
afnr: farn fran narf
enosst: onsets stones
aeiiprrs: prairies prierais
adepr: drape padre pared praed
addegln: dangled gladden
aeinpss: pansies sapiens
acent: canet enact
abeinr: bearin braine
aegimnrsu: geraniums measuring
elnor: enrol lorne
acdlu: cauld ducal
aestv: stave vaste vesta
deens: dense edens needs
chou: chou ouch
aegilnp: leaping pealing
adddeemn: demanded maddened
adeemrr: dearmer dreamer
defmor: deform formed
du: du ud
eillvy: evilly lively vilely
elotw: owlet towel
dorstu: stroud tudors
dggilno: golding lodging
aeprss: passer repass spares sparse spears
acenrsv: caverns cravens
cirstu: curtis rustic
abbes: abbes babes
gilmnoo: gloomin looming
abdelmr: marbled rambled
aprsy: prays raspy spray yspar
ahsty: hasty shtay
aaegilr: algeria regalia
et: et te
acddeeimt: decimated medicated
denos: denso nodes nosed
allry: llary rally
adnosu: sanudo soudan
aegllno: agnello galleon
eoprt: porte toper trope
aelmsy: elymas measly
abehoostu: boathouse houseboat
adeill: allied lladei
deeilrv: deliver delivre relived reviled
adinrsw: drawins inwards
gnorw: grown wrong
deghilst: delights slighted
dehis: hides shied
adder: adder dared draed dread
aaegssu: assuage sausage
ensw: news sewn
opst: post pots spot stop tops
adeimrs: admires misread
agi: aig gai
aagg: agag gaga
acciist: icastic sciatic
hipz: phiz ziph
eeilnps: pensile sleepin
civ: civ cvi
ceginrsu: rescuing securing
abnr: barn bran
ilnos: lions loins
cdeehinrst: christened discerneth
cdeirst: credits directs
aeirtt: attire tertia traite
deiprst: desprit striped
morsu: morus muros ormus
hos: ohs sho
aeimnt: amenti animte inmate menait
adno: adon doan dona
abdegr: badger garbed
cceinott: concetti tectonic
eimnorsu: monseiur monsieur
abegilnt: bleating tangible
ailms: islam mails salmi simla
adeflno: aldenof lafoden
apsty: pasty patsy
deewy: dewey weedy
aeginprstt: patterings spattering
opstu: pouts spout stoup
adeelprst: plastered relapsted
ceiklrst: stickler trickles
eiimnrsst: ministers ministres
aemort: amoret temora
cehikstt: thickest thickets thickset
cde: ced dec
eepsw: sweep weeps
lop: lop pol
aaahnnsv: havannas savannah
aegilmnnt: gintleman lamenting
dos: dos sod
adeinrt: redaint trained
aeehiprs: hesperia pharisee
cefirty: certify rectify
abinr: bairn barin brain brian
adelt: dealt delta
aalpp: appal papal
acist: scait sciat
gtu: gut tug
eipqtu: equipt piquet
aimrs: armis mairs
eeginns: engines insegne
aegimnrt: argiment emigrant remating
eforr: ferro oferr
adlo: load loda odal
begilno: gobelin ignoble
anu: anu una
abde: abed bade baed bead
ddeit: dedit tided
eiqsu: equis quies
aimprt: armpit impart
alt: alt lat tal
aelnps: naples panels planes
agilnstu: gulistan saluting
eilno: leoni onlie
eeilrsssst: resistless sisterless
adnrtu: durant tundra
eellrssstu: lustreless resultless
aegsu: agues usage
iop: pio poi
adehnpsu: daphneus unhasped
emty: emty emyt
ainor: arion orina
cehpsy: psyche pysche
adirsu: darius radius
bey: bey bye
ay: ay ya
aeimns: amiens animes imensa nameis semina
acelss: classe scales
ehirsv: shiver shrive
acelor: arcole oracle
eeemst: esteem esteme
emrsu: reums serum
eipss: pises spies
acers: acres cares carse escar races sacre scare
eehlorsss: horseless shoreless
efnort: forten oftner
aeilnr: linear nailer
einoprst: pointers proteins
hinopss: siphons sonship
ailst: laist stali tails
ceilorst: cloister costlier
imp: imp pim
aelpsy: apsley pasley
aestx: taxes texas
aehst: haste hates heats saeth
eemprst: permets tempers
abddeiimrs: bridemaids bridesmaid
ehilstt: listeth thistle
defils: feilds fields
iinosv: vision voisin
abdinr: briand riband
degins: deigns design signed singed
cehlw: elwch welch
adeeegnrt: generated greatened
abeilmr: blamire mirabel mirable
acnort: cantor carton contra
eirt: iter reit rite tier tire
deeinn: dennie needin
eeirstt: treiste trieste
adgmo: dogma madog
adlnvwyy: dyvynawl dyvynwal
acdeeilnrst: centralised credentials
aenrv: raven veran
agilnps: lapsing palings sapling
elry: erly lyre rely
ehms: hems mesh shem
enoptt: pontet potent
eimnst: mentis timens
ceot: coet cote
addenr: dander darned
adegnrr: gardner grander
acciorst: acrostic socratic
aagnrw: angawr gwanar
aailqu: aliqua aquila
cdlos: clods colds scold
eins: iens sein sien sine
abbbelr: babbler brabble
acdeh: ached dache
aeimnrt: martien minaret raiment
chinopty: hypnotic typhonic
ceenrs: censer screen
ceiop: copie piceo
ehlost: hostel hotels
abdeil: diable iebald
agrsu: argus sugar
defilrt: flirted trifled
aps: asp pas sap spa
aceilp: epical plaice
deeemst: deemest estemed
ceehlprsu: sepulcher sepulchre
aacllsuy: casually causally
aeeglnr: enlarge general
eimnstt: mittens smitten
hinrsu: inrush rushin
eirtt: titre trite
adegnr: danger gander garden grande ranged
deirsv: divers drives
alnost: alston laston talons
eess: esse sees
anoprs: aprons parson
agiinprs: aspiring praising
aceens: ceasen seance seneca
adrsw: draws sward wards
gnu: gun ung
eimnrv: mervin vermin
eossst: stesso tosses
rsu: rus sur
aclor: carlo carol coral
adegin: adigne gadeni gained
esy: eys yes
deelnr: lender rendle
eervy: veery verey
gnouy: guyon young
ehimrs: rheims rhimes
aenorst: senator treason
atu: aut tua
adgginr: grading niggard
deestt: detest tested
eortu: outer route
demsu: deums mused
emmrrsu: rummers summerr
ghilnstu: hustling sunlight
aberu: auber bauer
ansv: anvs vans
ddeenu: denude dundee endued
ehinoprsw: ownership shipowner
eekm: keem meek
aefrs: fares fears safer
adeoprrty: portrayed predatory
eeiimprssv: impressive permissive
abl: bal lab
ajr: jar raj
eiinors: ironies noisier
eersty: reytes yester
aepsst: pastes spates
eilotv: olivet violet voleit
ceehp: cheep peche
eelpr: leper lepre pelre repel
aklst: stalk talks
giilntw: wilting witling
agimnn: ingman naming
ceefprst: perfects prefects
aclors: carols corals
egins: sengi signe
ahirt: hairt raith tirah
ahnr: harn rhan
aloru: lauro raoul
errsttu: truster turrets
aanrw: anawr arawn arnaw wanar
deeelnss: endlesse lessened needless
ceilrs: relics slicer
dginootu: guotodin outdoing
