aceh: ache each haec
gip: gip pig
adeggr: dagger ragged
hiiknps: kinship pinkish
aeprst: repast tapers
aefmrrs: farmers framers
aegilnrt: altering integral relating triangle
behlssu: blushes bushels
abeorstt: abettors obstaret
chiors: choirs orchis
aehllnw: hanwell newhall
blru: blur burl
aeghinrtw: nightwear wreathing
gruy: guyr rygu
eilnsst: enlists listens
eirrt: riter tirer trier
aabhmr: abrahm brahma
aelmst: metals saltem
fglo: flog golf
aelmno: malone manoel
adddel: addled daddle
chrtw: trwch twrch
dnossy: dysons synods
aeprs: apres pears presa rapes reaps spare spear spera
atw: taw twa wat
aceilnor: caroline cornelia
alloy: alloy loyal
chilnot: chilton clothin
rty: ryt try tyr
cehrs: chers serch
aelpt: leapt petal plate pleat
agnps: pangs spang
anosx: naxos saxon
cgiklnsu: sculking suckling
agims: magis sigma
dmoos: dooms moods sodom
deis: dies side
dgimnoo: domingo dooming
aessv: saves vases
acmrsu: marcus sacrum
deikl: dilke liked
agorst: argots groats
enrt: rent tern tren
cdeeirrtu: diceretur recruited
first: first rifts
ilmo: limo milo moil
ceeeirv: receive recieve
histw: whist wisht
adehmmmo: mahommed mohammed
ceimor: comrie cromie
agln: glan lang
acert: carte cater react recta trace
ehlorsst: holsters hostlers
accgikln: cackling clacking
acdehs: cashed chased
cginry: crying cynrig
aeimrt: maitre merita
acns: cans scan
dehissw: swedish swished
eorssu: rouses soeurs
acdeennst: ascendent tendances
deert: deter treed
enors: norse rosen senor snore
cehirt: crieth thrice
def: def fed
cefors: forces fresco
deefinrs: fernside friendes
ceh: che ech
aeint: aient eatin entia etain intae taine teian
aklr: karl lark
ceinnoorssu: connoiseurs connoisseur
aegrw: agerw gware wager
afist: faits fiats
mru: mur rum
ellm: mell mlle
agorstu: ragouts rogatus
ahmrs: harms marsh
ddenru: dendur undred
berstu: brutes buster butser
aerz: ezra raze
eors: ores orse roes rose sero sore
mvy: myv vym
eilo: eloi oeil
cdeiorsv: discover divorces
aaegin: aegina againe
aeemns: meanes seamen
dehoorstu: herodotus theodorus
efgior: forgie fregio
deisst: deists desist
einv: vein vine
adgo: dago goad
eeenrt: entree eterne
adesty: stayed steady
dnorw: drown rownd
mos: mos som
eegrs: reges serge
ailty: italy laity
ehimr: ihrem rhime
aeerst: easter eaters reseat teares teresa
aehirt: areith erthai
esu: seu sue use
elms: elms smel
eilnswy: swinley winsley
eflno: felon lefon
aelrs: arles earls lares reals
bbeilos: bilboes lobbies
aceinooprrt: incorporate procreation
aemprt: partem patrem tamper
airstt: artist raitts strait traits
eop: ope poe
bekr: brek kerb
eilwy: wiley wylie
aeilnorsst: orleanists orleansist
adej: deja jade
aenrtu: enurta nature
anpsw: pawns spawn
adeflo: foaled loafed
aekmrr: marker remark
abnor: baron bonar boran
aaceimrs: americas macaires
eiknv: kevin viken
aersst: assert asters stares
ehrsu: shure usher
eeinnv: evenin vienne
aemt: mate meat meta tame team tema
bo: bo ob
hiosst: hoists hostis
artwy: arwyt watry
ehlls: hells shell
derru: durer ruder
ekorsst: stokers strokes
ceepr: creep crepe
aceghinrs: reachings searching
efils: files flies lifes
aehnrtu: haunter unearth
imo: imo mio moi
aderst: darest stared trades treads
aeffimrr: raffermi reaffirm
agins: gains signa
acderr: carder redcar
adeim: aimed media
aelln: allen nella
aev: ave eva
adeegnr: angered derange enraged grandee grenade
aimnr: arnim marin
eefrs: frees reefs
aaddh: hadad hadda
aagor: agora arago
bino: bion boni
deeforst: forested fostered
adeiprr: drapier parried
aes: aes sae sea
ersst: rests tress
brstu: bruts burst
deilt: tilde tiled
aginprt: parting prating
acirt: artic cirta
deeoprs: deposer reposed
anoprst: partons patrons
adehnr: danher harden
anorwy: norway yonawr
cinorsu: rusconi scourin
acehlt: chalet chatel
cinos: coins icons scion sonic
bceirs: brices briesc scribe
aaceglostu: catalogues coagulates
cffinos: coffins scoffin
einnprs: pinners spinner
nost: sont tons
eehrst: esther hester threes
iil: ili lii
eiorsst: rosiest sorites stories
elp: elp pel
civx: cxiv cxvi xciv xcvi
celnoy: ceylon cloyne
eeinrsstt: interests triteness
einpy: piney ypine
acehnsst: chastens snatches
adeeistv: deviates sedative
aelmpr: ampler marple palmer
hoost: hoots shoot sooth
bdeilrst: bristled driblets
eginstw: stewing twinges
denry: deyrn edyrn
delostu: loudest tousled
amor: amor maro mora omar roam roma
aeegginnrt: generating greatening
cep: cep pec
eilrsv: livers livres silver sliver
aemnrsu: mensura surname
eiiklnor: ironikle ironlike
adeilnsw: elwandis winslade
acem: acme came mace
ersttu: truest utters
bdemoy: dombey embody
nrstu: nurst turns
aeipstt: patties peattis
deeinv: devine endive envied veined
aeepprr: paperer prepare
almu: alum maul
adeprs: drapes padres rasped spared spread
acinotu: auction caution
ad: ad da
abgs: bags gabs
aeipprs: apprise papiers
eemrst: merest mestre meters metres termes
acehpr: pearch percha preach
ahmss: shams smash
egilnrst: ringlets sterling
aaprv: parva prava
abddeiors: broadside sideboard
npsu: puns spun
adehrtw: dewrath draweth
eoprsstu: postures spouters
beenru: nubere reuben
hou: hou huo
acegilnv: caveling cleaving
door: door odor ordo rood
abdey: abyde bayed beady
cdeeeptx: excepted expected
noos: noos oons sono soon
aeglns: angels angles gleans
ary: ary ayr ray yar
eegmr: merge regem
eijnno: enjoin jonnie
opsst: posts spots stops
abels: bales basle blase lebas sable
anorty: ayrton notary
ace: ace cae
cdnoory: corydon croydon
ensu: neus sune
deers: deers reeds
celoor: colore cooler
abdeglr: dalberg garbled
eiw: wei wie
efn: fen nef
adeelprs: pleaders relapsed
anor: arno oran roan
beginss: besings bigness
ahistu: authis hiatus
adilorty: adroitly dilatory idolatry
aceilr: claire clarie
enrty: entry teyrn
aels: ales alse elsa leas sale seal
adeemrrs: dearmers dreamers
ilu: ilu liu lui
ddeiort: diderot trioedd
beggin: beggin biggen
aerstv: starve vaster vaters
adhs: dash shad
eenrst: enters ernest resent serent sterne
aelrstw: walters wastrel
ablm: balm lamb
cdeeu: deuce educe
efginrs: fingers fringes
forst: forts frost
cehss: chess sechs
adeinnttu: inattendu untainted
noru: ourn roun
mot: mot tom
deeiprss: despiser disperse presides
abekrs: bakers brakes breaks
aegnr: agren anger grean range regan
efmor: forme frome
ceelmnt: clement tlemcen
aginov: giovan vigano
aadgr: argad garda
adru: daru dura
emm: mem mme
eepr: peer pere
go: go og
cix: cix cxi xci
eeeprrsv: perverse preserve
ntu: nut tun
eiorst: sortie tories
gmsu: gums mugs smug
ior: rio roi
almtu: mault multa
adds: adds dads sadd
adelns: landes sladen
eeinrstu: retinues reunites
hort: roth thor thro
eort: orte reto rote tore
achiinrst: christian christina
adginoor: giordano rigadoon
aellry: really yaller
ahilrw: awhirl lawhir
abelmr: marble ramble
degru: rudge urged
eln: len nel
acps: caps pasc
aagnr: angar nagar
ceeilrstu: cruelties reticules
aiot: iota tiao
eginoprtt: pottering pottinger
aelnrtu: laurent naturel neutral renault
bmoos: booms bosom
ap: ap pa
aott: atto tato
eegns: genes neges
ceeeipprstv: perceptives perspective
deelu: elude uedel
adehrs: dasher shared
mtu: mut tum
deopru: poudre poured
adegnrt: dragnet granted
el: el le
hnorstu: rushton shurton
eginsw: sewing winges
eortz: terzo tozer
ghinostu: shouting southing
abcehlor: bachelor lochaber
celru: cruel lucre
eems: esme mees mese seem
eehst: seeth sheet
deeirs: desier desire reside
ddegilnu: deluding indulged
aeginrr: angrier earring garnier rearing
acdelu: claude ducale
adeprt: depart parted petard prated
aacenrst: ancaster caterans
eerssv: serves severs sevres verses
ainpss: passin spains
deirst: direst driest ridest stride
aceiinottx: excitation intoxicate
psu: sup ups
hsy: hys shy
bmoo: boom ombo
hiorrt: orthir thorir
ceilpprs: clippers cripples
acehr: chear reach
aderv: drave raved
adeeirr: drearie readier
cfhilt: flicht flitch
eghilrt: lighter relight
rtwy: trwy wryt
deiiors: isidore osiride
dinr: drin rind
defin: fiend finde fined
aegs: ages gaes sage
aehirrt: arreith harriet raither
aeghrt: gather rageth
agps: gaps gasp
efilrrst: flirters triflers
erv: rev ver vre
aft: aft fat
eilott: lottie toilet
aeenrstt: entreats restante
adgilnr: darling grindal larding lingard
adenopr: aproned padrone parendo
degu: geud gude
aenw: anew awen waen wane wean
fry: fry fyr
iprs: pris rips spir
aiimnnos: insomnia simonian
acehst: chaste cheats sachet
cloo: cool loco
aefnsst: fastens fatness
aelrsv: salver slaver versal
deiv: dive vedi vide vied
acden: caned dance
aceerrt: caterer retrace terrace
cenors: censor crones
ahils: hails salih
aeinn: annie inane
ans: ans nas san sna
eefloprsu: forepulse reposeful
aceps: capes paces pasce scape space
aefgn: fegan ganef
eghlpsu: guelphs pleughs
hino: hoin honi
aeilnrt: relatin reliant
einrsu: insure ursine
ahrt: arth hart thar
aeirtv: vatier virate
einops: poisen ponies sinope
aellrw: llawer waller
deiinost: editions sedition
abbbgiln: babbling blabbing
act: act cat
derwy: dwyre erwyd
enorst: estron noster seront stoner tenors
cilru: luric ulric
ciknosw: cowskin wickson
bbdeir: bribed ribbed
adelv: laved valde
aiinprs: inspira praisin
eissu: issue susie
ceehilln: chenille hellenic
aceilrtuv: lucrative revictual
dewy: dewy wedy
erwy: wery wyer wyre
ceeipr: peirce pierce recipe
acein: aince naice
adnosw: dawson sandow
apsu: apsu paus upas
pu: pu up
agimnst: masting matings
deinrs: diners rinsed snider
deefin: define feedin feinde
ddeorsw: drowsed sworded
ailpst: plaits spital
hnor: horn nhor
aeglnrs: anglers rangles
diks: disk kids skid
anv: avn nav van
adegrrs: graders regards
amory: amory mayor moray
illsw: swill wills
aginw: gawin wigan
adghins: dashing shading
aegimnn: magnien meaning
eghilrst: lighters slighter
ceehr: cheer chere erech
aabceelrt: creatable traceable
aeilms: ismael samiel
aailss: assail laissa
aepry: payer repay
adeelnr: leander learned
bdenoru: bounder rebound
amry: army mary myra
aenr: earn near raen rane
adinor: dorian inroad ordain
amnwy: amwyn wyman
aemrstt: matters smatter
aahmn: haman mahan
eeimrt: merite metier timere
eilmn: ilmen milne
airu: airu auri
ceeirt: cretei ecrite recite tierce
aaeiprsst: aspirates parasites
acdeeilnr: declinare icelander
uz: uz zu
adlnpu: dunlap upland
adior: doria radio
agiklnst: stalking talkings
bdeorstu: doubters redoubts
aacesu: aeacus causae
delw: delw dwel lewd
ahtu: haut utah
aar: ara raa
aeegl: eagle egale
fgiilnst: liftings stifling
ako: kao oak
adeeghrt: gathered greathed
abeglmr: gambler gambrel
acellry: carlyle clearly
suy: ysu yus
noottw: towton wotton
abeehrt: beareth breathe
aeisssst: assistes sassiest
asu: aus sua usa
eefl: feel fele flee
aeinort: aretino ratione
abeirrt: arbiter rarebit
aclu: caul luca
aimnor: marino marion minora
adehrt: dearth hatred thread
aelmt: malte metal
eirw: iwer weir wier wire
fstuy: fusty tyfus
ellnottty: lyttelton lyttleton
abgilnr: blaring brignal
acflnos: falcons flacons
egint: teign tinge
adep: aped pade
hisu: hsiu shui
aenost: atones seaton
aceinorrt: contraire contrarie
ahllo: hallo holla
deggru: grudge rugged
aemrssu: amusers assumer erasmus
abg: bag gab
giiklnn: inkling linking
bgru: brug burg grub
ansty: nasty tansy
acev: avec cave ceva
aegrst: grates stager
einrw: enwir werin
aeeilntttvy: attentively tentatively
egiin: genii ginei
imnot: minto monti timon
ehoprt: pother thorpe
adeeinprt: pertained repainted
abceh: bache beach
ikrst: skirt stirk
agrw: garw gawr
aelpst: palest pastel petals plates pleats staple
cstu: cuts tusc
hopprryy: porphyry prophyry
deguy: guyed gyued
aeilrs: israel sailer serial
degilrs: gilders girdles
aehlrst: lathers thalers
opr: orp pro
nos: nos son
aeiln: alien anile laine
imrs: misr rims
ainnorst: arniston nostrani
adellnw: llanwed welland
eerv: reve veer vere
eilstv: livest vilest
aegrrst: garrets garters
ahp: hap pah
deilos: loides soiled
aelpps: appels apples
acelrt: cartel claret clarte
ells: ells lles sell
deenru: endure enured
ddny: ddyn nydd
ailort: rialto tailor
int: int nit tin
eemntu: tenuem unmeet
aaden: adaen aedan
eltuu: leutu teulu
deelsy: sedley yeelds
aacceinnorst: anacreontics transoceanic
acderw: cardew racwed
alprty: paltry partly raptly
eellw: ewell welle
im: im mi
abddeer: bearded breaded
aelrtv: travel valter varlet
eeinr: ireen irene
biis: ibis sibi
giinrv: irving virgin
gins: ings sign sing
aaeilr: aerial realia
ilnoot: lootin lotion
abcehmry: chambery chambrey
acghin: aching chiang
llno: llon noll
ail: ail ali lai
aeeglr: galere regale
aeegrs: agrees grease
cnors: corns scorn
blnotu: blount unbolt
ehils: sheil shiel
rssuu: rusus ursus
adiry: dairy diary
aelrt: alert alter later
iosst: istos sisto
eeginrrsv: reserving reversing
eeimnn: mienne niemen
agost: goats togas
aeenopru: europaen european
hop: hop pho poh
aefrv: faver favre
afin: afin fain
gino: goin ogni
aemty: etyma meaty
deilms: misled smiled
adeenr: earned endear neared
acno: anco cona
aabeilm: aimable amiable
dely: dely dyle elyd
ahint: haint hatin
imss: miss sims
aalst: atlas talas
deilst: idlest listed silted stiled
adehln: handel handle
eimntu: minuet minute
aipr: pair pari
lost: lost lots slot
aeelps: asleep elapse please
adeor: adoer adore
aegnor: orange organe
dmnou: mound mundo
eoprstu: posture pourest troupes
astv: vast vats
aeghint: aething heating
acelt: calet eclat
ehiintv: thievin veithin
ahpt: path ptah
chi: chi hic ich
ersstw: strews wrests
eilostv: olivets violets
adegnrst: grandest stranged
beglsu: bugles bulges
allo: allo olla
imrsstu: sistrum truisms
ddeemrru: demurred murdered
adis: aids dais dias sadi
abdimor: bormida morbida
deimr: mired rimed
adels: dales deals leads seald
assty: sayst stays
egl: gel leg
ddeefii: deified edified
errsty: restyr terrys
bhorst: broths throbs
cin: inc nic
admr: armd dram mrad
bcdeeemr: december decembre
girst: grist grits
alnos: loans salon sloan
ceffors: coffers scoffer
giillnt: lilting tilling
eeiinoprstt: petitioners repetitions
ehkoorsuw: housework workhouse
hksu: husk kush
del: del eld led
abden: abend baden bande
emot: mote tome
aintx: taxin xtian
adost: doats toads
deinor: indore ironed ordine
eiimnoprss: impression permission
egisu: guise segui
adeghorst: goatherds grosthead
ginprsuu: pursuing usurping
aortu: aruot tauro
einpt: inept peint
aceg: agec cage
aceinorrst: contraires contraries
bemort: tomber trombe
acehrrst: charters chartres
deeirsv: derives diverse revised
achinor: chirona horican
gimnsu: musing signum
eillnt: lintel tellin
ehint: neith thine
ehinrs: rhines shrine
ads: das sad
ddeefil: defiled difedel
aaimr: amari maria
acegimnr: creaming germanic
ainstu: austin unitas
acehis: chaise chiesa
aggirw: gwraig gwrgai
acfit: facit faict
flu: ful ulf
deirw: weird wider wierd wired
abeu: aube beau
abdeet: debate debeat
acelmn: mclane mclean
adennoy: annoyed anodyne
aenrt: earnt nater
aceers: cesare crease
ahhs: hash shah
iknss: sinks skins
amost: amost atoms moats tomas
denprstu: purtends sprunted
eginors: ignores regions signore
aanst: santa satan
egior: ogier orgie regio rogie
aostt: stato stoat toast
deginns: endings sending
ceor: cero core
acinostu: auctions cautions
delor: doler loder older
alv: lav val
aegins: easing gaines
hiorsty: history toryish
gnw: gwn wng
ers: res ser
ainoss: ossian saison
eeglnt: gentel gentle
aekqsu: quakes squeak
eelsv: elves leevs
abdes: based beads
euv: veu vue
acinnor: corinna cronian
agnors: groans organs sargon
aems: ames maes same seam
eilns: liens lines niles
aesv: save vase
aeltv: atvel valet
degiinrss: desirings rigidness
achioopsyz: psychozoia pyschozoia
eehrsy: heresy hyeres
ery: eyr rye yer
acinnoss: cnossian scansion
eorsty: oyster storey troyes
aemnr: maner meran
ceorssu: courses croesus sources
hstu: huts shut thus tush
cdeeers: decrees recedes
ademnnu: mundane unnamed
achimnsu: humanics inasmuch
aeehrtw: weather whereat wreathe
ceelst: elects select
ailm: lima mail
cdeeoprru: procedure reproduce
ailnst: instal lastin latins lisant slatin
ehirrs: hersir hirers
ev: ev ve
adenrw: andrew drawne wander warden warned
aceilnoptu: peculation unpoetical
abdenr: bander benard brande
adeiirs: dairies diaries
aberrst: barrets barters
belorst: bolster lobster
gnsu: guns snug sung
dfgilnnou: foundling unfolding
estu: suet sute
acdenr: craned dancer
ersty: tryes tyres ystre
aiorsv: savior savoir varios
aelqu: equal quale queal
deeeinrr: derniere reindeer
deeirss: desires resides
aeghinrstt: shattering straighten
ddefor: fodder forded freddo
deloos: dooels loosed
aceimnr: carmine crimean mercian
eorsu: roues rouse
abht: bath htab
aeiirsst: satirise tiresias
adeglr: gardel gerald glared legard
aclrsw: crawls scrawl
eesst: esset estes seest
aeghilnoost: anthologies theologians
dimor: dirom dormi
anruwy: runway unwary
ddeefnru: refunded underfed
eegnt: genet gente
addeeprv: depraved pervaded
aasv: sava vasa
moor: moor moro room
ghlou: ghoul lough
denou: doune ouden
acellr: caller cellar recall
eeenrst: entrees neerest
abeilst: bastile bestial
deen: dene eden need
adnorw: onward rawdon
efllow: fellow fowell
bcrsu: crubs curbs scrub
aeeimnnortu: enumeration mountaineer
eelnpss: penless spleens
dop: dop pod
aghns: gnash hangs shang
acdep: caped paced
gotuy: gouty guyot
eiqstu: questi quiets
adm: dam mad
cnory: corny crony
acdorwy: cowardy cowyard
ehmorst: mothers smother thermos
alstu: salut sault talus tulsa
acehkr: charke hacker
aehimnors: harmonies harmonise
aefhrt: father fraeth freath
elor: lore role
abefr: faber fabre
adenw: adwen endaw waned
einps: pensi pines snipe spine
eginrw: gwerin gwrien
ceinst: incest insect nicest
ceirrssu: cruisers scurries
aegnrs: angers ranges sangre
abhmoort: bathroom robotham
adinors: inroads nidaros ordains
acdeeilnrt: credential interlaced
aelmnort: marleton montreal
dioprst: disport tripods
beginn: benign bingen
degilw: gelwid wledig
aillsw: lliaws wallis
cdhi: chid dich
deiln: dilen lined neild
hops: hops shop soph
ademnu: maunde unmade
acenrs: carnes cranes
ahilps: palish phials
eginrss: ingress resigns signers singers
agst: gast stag tags
ilpss: lisps slips
emsu: mesu muse
aenrrt: errant ranter
aegno: agone genoa
efirs: fires fries
eilmps: impels simpel simple
ceiklnrs: clinkers crinkles
ixxx: xxix xxxi
aeelrsst: arteless tearless
ilno: lion loin olin
deiinnosst: dissention distension
ceiinrsstu: scrutinise sinecurist
aehnr: haren hearn
aeilnrst: entrails ratlines
egilrw: gelwir gwelir
adg: dag gad
gilnop: loping poling
deirtu: reduit treidu
aaailnrstu: australian saturnalia
aemssu: amuses assume
eenrsssu: sureness suresnes
agnn: nang ngan
eips: ipse peis pies
ahlst: halts laths shalt
egort: grote roget
hnopty: python typhon
aist: ista sait
ademot: admote moated
afmo: foam foma
aehprrs: harpers sharper
aehls: heals leash sahel
ailny: inlay layin
bstu: bust buts stub tubs
blosw: blows bowls
ailopst: ospital topsail
cdoru: croud duroc
egnos: segno songe
cdeenorsv: conserved conversed
akrs: arks kasr sark
cefht: fecht fetch
aailsv: avails saliva valais
ips: pis sip
aiillnsv: villains villians
epst: pest pets sept step
behirrt: brither rebirth
eehhirttw: therewith withereth
cosstu: custos scotus scouts
aeelv: leave valee
eloy: oley oyle
aadmnr: armand mardan
aceinnoorstv: conservation conversation
ehoopstu: housetop pothouse
eenrv: nerve never verne
guy: guy uyg
acilr: clair crail
eeprsu: peruse rupees
aceinrt: certain crainte incerta
ciorsu: curios sicuro
agilnoprt: patroling polignart
aelt: alte late tale teal
aefrttu: fatture tartufe
clotu: clout culto
cessu: scuse secus
aerst: aster earts rates stare tares tears
amort: marot morat
aginrv: garvin raving
inortt: rottin triton
ceehru: eucher euchre
ov: ov vo
aehmnt: anemth anthem hetman
adot: doat toad
aepss: apses passe
aeginnr: earning nearing
eeelpsst: sleepest steeples
acinnost: contains sanction
cdduy: cuddy dyduc
msu: mus sum
not: ont ton
adgiln: glinda lading
aertw: ewart waret water
demnor: modern morden
ceelors: coleres creoles
acgirs: cigars craigs
eersstt: setters streets
cdeno: conde donec
addgilnw: dawdling waddling
aaceimr: america macaire
deep: deep depe pede
aaeemnrt: aeternam maneater
almps: lamps palms plasm psalm
anotu: auton tonau
aeors: aeros arose
alno: alon laon loan nola
deelprsu: preludes repulsed
adde: adde aedd dead
ceeinrs: censier sincere
deeinssw: dewiness wideness
eerrtu: reuter treuer
bcdemnou: duncombe uncombed
degilr: gilder girdle
anorstu: roustan sauront
eeinnst: intense sennite
cdeiinrstt: distincter interdicts
ainsstu: austins sustain
eeegnr: genere greene
deiorsw: dowries rowdies
aberr: barer brera
addeglu: dugdale gaulded
acnst: canst scant
eoprtu: pouter puerto troupe
aacdeglotu: catalogued coagulated
abls: albs slab
aiprst: pairts partis pirats
elpy: pyle yelp
aeilnt: entail latine
deiostu: outside tedious
achnst: chants snatch stanch
fhort: forth froth
deips: pieds spied
eghins: hinges neighs
eglou: goleu gouel
aamr: aram arma mara
aennoot: noaeton onaeton
aeilss: aisles laisse lassie
acellrs: callers cellars recalls
abders: beards breads debars
aadir: adair daiar
beosy: boyes obeys
deegls: ledges sledge
aelmopsy: maypoles playsome
efflrtu: fretful truffle
aadeelnrx: alexander alexandre
addeemnst: damnedest demandest
abeirrz: bizarre brazier
eerstuv: vertues vesture
beeeilv: beleive believe
eefs: fees fese
ims: mis sim
deegw: gwede wedge
aegllry: gallery largely regally
horstu: hortus thurso
eotv: veto vote
dggginru: drugging grudging
aaimn: amain anima mania
deepru: dupree perdue
adlmno: almond dolman maldon
ehirs: heirs hires sheir shire
aadeginrr: arraigned arrainged
deeiopss: episodes possiede
deist: deist diest diets dites edits tides
deeirrs: desirer serried
abor: boar bora roba
alst: last salt slat
aeilmnt: ailment aliment
adderw: drawed edward warded
ehlorst: holster hostler
ehmny: hymen hymne ymhen
celsttu: cutlets scuttle
ghilst: lights slight
eegnrst: gestern regents sergent
aceilmst: claimest clematis climates
eorstw: towers towser
gnrstu: grunts strung
adeeiprrs: despairer draperies
eelmry: meerly merely
deelnst: lendest nestled
ceefnorr: confrere enforcer
adeegnrr: gardener garnered
bceeehs: beeches beseech
deinstt: dentist stinted
elrttu: lutter turtle
abtu: abut tuba
iilvx: lxvii xlvii
aanssu: assuan nassau
mnot: mont tomn
denosw: endows snowed
einor: noire norie rione
ehtw: thew whet
eeiqrstu: queriest requites
abehlnooru: honourabel honourable
aosstt: stoats toasts
aissst: assist stasis
aeeintttv: attentive tentative
binr: birn brin
aaaimnrt: araminta marinata
hmu: hum umh
efor: fore froe
aceeehnpttu: tehauntepec tehuantepec
ahllosw: hallows shallow
giilnst: stiling tilings
adeintw: adwenit tinwaed
eiimnrst: minister ministre
app: app pap
abdet: bated debat
adeer: deare reade
ilo: lio loi oil
eirstt: sitter titres triest triste
aadgnr: gadarn granda
deeins: denies diesen
agiln: align liang
afinst: faints fastin
aehorstwy: otherways seaworthy
eimpru: impure umpire
cefhint: fechtin fetchin
ilvxxx: lxxxiv lxxxvi
cdeorsu: coursed scoured
eehnorw: nowhere whereon
acerrst: carters craters
cllu: cull lluc
iinnop: opinin pinion
lmpuy: lumpy plumy
aeilnps: plaines pleasin spaniel
bdennruu: unburden unburned
aeinnrstt: instanter transient
enot: eton note tone
acsuy: saucy yucas
aemrs: amser armes mares reams smear
dfilno: dolfin infold
enstt: stent tents
eflsu: flues fuels
efll: fell llef
ceimostv: vicomtes viscomte
aaceln: canale lancea
acort: actor arcot atcor cator
ehorsw: shower showre whores
eghit: eight geith tighe
abddeu: beddau daubed
deeffnor: forefend offender
ceipt: cepit epict
dnou: doun undo
almp: lamp palm
acghinnst: snatching stanching
ailrt: altri trail trial
abdeelt: belated bleated
ahkn: hank kahn khan
adeilttu: altitude latitude
ddru: drud rudd
aehrsw: hawser wheras
adeesv: desave evades
aehiln: healin inhale
eeiprr: pierre priere reperi
deimnps: impends mendips
bdeeil: belied edible
beinsssu: buisness business
aehny: hayne hyena
ghostu: gothus sought
arw: awr raw war
aein: aine iaen
aeelprssu: pleassure pleasures
denorst: rodents snorted
agn: ang gan nag
aepprs: papers peraps sapper
adirs: airds raids
eorssty: oysters storeys
dehinrs: hinders shrined
eennrt: rennet tenner
agilmn: laming malign
ceiort: erotic recito
aehtu: haute heaut
hnu: hun nhu
osv: sov svo vos
bnos: bons nobs snob
bel: bel ble
aegnrv: garven graven
aefor: afore faroe
ceirst: certis criest ecrits
cdeeorst: corseted escorted
degilnt: glinted tingled
degir: deigr dirge dreig ridge
affhilns: hafflins shiffnal
ddeggru: drugged grudged
deorw: dower rowed
aelsv: laves salve slave vales
cinru: incur runic
ghos: gosh hogs
aceimr: crimea mercia
ciopst: optics topics
aegv: gave vega
einsw: sewin sinew swine wines
effort: effort offert
eegnry: energy greeny
cdeeirttu: certitude rectitude
dinos: doins sidon
aemss: masse mesas seams
hirt: hirt thri
aefinr: fairne fearin
aemm: emma mame meam
mrty: myrt trym
lmu: lum ulm
eilmnooops: monopolies monopolise
eeilmnosst: limestones milestones
giorv: vigor virgo
iknt: knit tink
ciors: crois osric
abdeert: berated debater
anrtu: arnut natur truan
emosu: mouse omues
eiknsv: knives nevski
aeeintv: naivete venetia
eoprrt: porter report
allmory: mallory morally
aelnpt: planet platen
emnoorst: montrose somerton
deersst: deserts dessert
aemqrssu: marquess masquers
acdeoorrt: decorator trocadero
adeeprstt: departest spattered
eipst: epist petis spite
aceilpru: peculiar pericula
adelnrs: slander snarled
aeflrtu: faulter tearful
erst: erst rest sert tres
ioss: ossi sois
aeks: aske sake
attwy: watty wyatt
aainnorv: arvonian navarino
ceefhlru: cheerful chereful
cdeersu: reduces rescued secured seducer
anst: ants sant satn stan
aeinrsv: ravines servian
aceegil: elegaic elegiac
imot: miot omit
dgrw: drwg gwrd
hoop: hoop pooh
amrs: arms mars rams
adeelr: dealer leader
adehirr: hardier harried
aegl: egal gale
otu: out tou tuo uot
ceorsw: cowers scowre
